Season,Player,Pos,Age,Tm,G,GS,MP,FG,FGA,FG%,3P,3PA,3P%,2P,2PA,2P%,eFG%,FT,FTA,FT%,ORB,DRB,TRB,AST,STL,BLK,TOV,PF,PTS
2001-2002,Tariq Abdul-Wahad\abdulta01,SG,27,TOT,24,12,441,55,147,0.374,1,2,0.5,54,145,0.372,0.378,24,33,0.727,41,43,84,24,20,10,27,56,135
2001-2002,Tariq Abdul-Wahad\abdulta01,SG,27,DEN,20,12,417,55,145,0.379,1,2,0.5,54,143,0.378,0.383,24,32,0.75,39,39,78,22,18,9,24,51,135
2001-2002,Tariq Abdul-Wahad\abdulta01,SG,27,DAL,4,0,24,0,2,0,0,0,,0,2,0,0,0,1,0,2,4,6,2,2,1,3,5,0
2001-2002,Shareef Abdur-Rahim\abdursh01,PF,25,ATL,77,77,2980,598,1297,0.461,21,70,0.3,577,1227,0.47,0.469,419,523,0.801,198,498,696,239,98,81,250,214,1636
2001-2002,Courtney Alexander\alexaco02,SG,24,WAS,56,28,1325,223,474,0.47,5,18,0.278,218,456,0.478,0.476,98,121,0.81,43,105,148,86,35,7,60,113,549
2001-2002,Victor Alexander\alexavi01,C,32,DET,15,0,97,18,51,0.353,0,2,0,18,49,0.367,0.353,4,8,0.5,7,22,29,6,0,1,5,6,40
2001-2002,Malik Allen\allenma01,PF,23,MIA,12,2,161,22,51,0.431,0,1,0,22,50,0.44,0.431,8,10,0.8,15,23,38,5,3,8,2,16,52
2001-2002,Ray Allen\allenra02,SG,26,MIL,69,67,2525,530,1148,0.462,229,528,0.434,301,620,0.485,0.561,214,245,0.873,81,231,312,271,88,18,159,157,1503
2001-2002,Rafer Alston\alstora01,PG,25,MIL,50,7,600,66,191,0.346,27,71,0.38,39,120,0.325,0.416,18,29,0.621,10,62,72,143,32,2,40,42,177
2001-2002,John Amaechi\amaecjo01,PF,31,UTA,54,0,586,54,166,0.325,0,0,,54,166,0.325,0.325,67,105,0.638,52,57,109,29,7,10,55,64,175
2001-2002,Chris Andersen\anderch01,C,23,DEN,24,1,262,25,74,0.338,0,4,0,25,70,0.357,0.338,22,28,0.786,38,38,76,7,7,28,13,35,72
2001-2002,Derek Anderson\anderde01,SG,27,POR,70,27,1860,247,612,0.404,85,228,0.373,162,384,0.422,0.473,178,208,0.856,47,142,189,216,68,8,87,113,757
2001-2002,Kenny Anderson\anderke01,PG,31,BOS,76,76,2430,312,716,0.436,9,33,0.273,303,683,0.444,0.442,98,132,0.742,57,218,275,403,141,10,119,210,731
2001-2002,Nick Anderson\anderni01,SG,34,MEM,15,0,219,21,76,0.276,13,48,0.271,8,28,0.286,0.362,5,9,0.556,1,32,33,14,6,6,14,17,60
2001-2002,Shandon Anderson\andersh01,SG,28,NYK,82,6,1596,149,373,0.399,39,141,0.277,110,232,0.474,0.452,74,107,0.692,57,192,249,76,48,15,97,134,411
2001-2002,Greg Anthony\anthogr01,PG,34,TOT,60,38,1514,183,475,0.385,48,163,0.294,135,312,0.433,0.436,60,91,0.659,22,110,132,282,77,5,94,114,474
2001-2002,Greg Anthony\anthogr01,PG,34,CHI,36,35,961,113,287,0.394,29,90,0.322,84,197,0.426,0.444,47,70,0.671,16,72,88,203,49,4,58,72,302
2001-2002,Greg Anthony\anthogr01,PG,34,MIL,24,3,553,70,188,0.372,19,73,0.26,51,115,0.443,0.423,13,21,0.619,6,38,44,79,28,1,36,42,172
2001-2002,Gilbert Arenas\arenagi01,PG,20,GSW,47,30,1155,174,384,0.453,39,113,0.345,135,271,0.498,0.504,124,160,0.775,41,91,132,174,69,11,97,115,511
2001-2002,Brandon Armstrong\armstbr01,SG,21,NJN,35,0,196,27,85,0.318,5,17,0.294,22,68,0.324,0.347,5,10,0.5,10,6,16,8,7,1,8,26,64
2001-2002,Darrell Armstrong\armstda01,PG,33,ORL,82,79,2730,347,828,0.419,139,398,0.349,208,430,0.484,0.503,182,205,0.888,83,236,319,453,157,10,175,166,1015
2001-2002,Carlos Arroyo\arroyca01,PG,22,TOT,37,1,371,49,111,0.441,0,2,0,49,109,0.45,0.441,13,18,0.722,12,28,40,70,11,1,23,30,111
2001-2002,Carlos Arroyo\arroyca01,PG,22,TOR,17,0,96,13,29,0.448,0,0,,13,29,0.448,0.448,4,6,0.667,3,9,12,21,6,0,12,12,30
2001-2002,Carlos Arroyo\arroyca01,PG,22,DEN,20,1,275,36,82,0.439,0,2,0,36,80,0.45,0.439,9,12,0.75,9,19,28,49,5,1,11,18,81
2001-2002,Chucky Atkins\atkinch01,PG,27,DET,79,62,2285,368,790,0.466,138,336,0.411,230,454,0.507,0.553,83,120,0.692,31,127,158,263,72,11,128,177,957
2001-2002,Stacey Augmon\augmost01,SG,33,CHH,77,3,1319,140,328,0.427,0,3,0,140,325,0.431,0.427,77,101,0.762,59,166,225,103,56,12,54,115,357
2001-2002,Isaac Austin\austiis01,C,32,MEM,21,8,307,36,92,0.391,0,3,0,36,89,0.404,0.391,4,4,1,11,60,71,13,9,5,11,36,76
2001-2002,William Avery\averywi01,PG,22,MIN,28,0,258,26,90,0.289,6,35,0.171,20,55,0.364,0.322,13,19,0.684,4,20,24,36,7,0,19,17,71
2001-2002,Dalibor Bagaric\bagarda01,C,21,CHI,50,0,638,72,178,0.404,0,1,0,72,177,0.407,0.404,41,70,0.586,55,107,162,23,17,24,46,108,185
2001-2002,Vin Baker\bakervi01,C,30,SEA,55,41,1710,315,649,0.485,1,8,0.125,314,641,0.49,0.486,143,226,0.633,168,182,350,72,22,36,127,197,774
2001-2002,Erick Barkley\barkler01,PG,23,POR,19,4,228,24,68,0.353,1,7,0.143,23,61,0.377,0.36,9,10,0.9,5,13,18,34,17,1,12,29,58
2001-2002,Dana Barros\barroda01,PG,34,DET,29,20,582,74,192,0.385,24,71,0.338,50,121,0.413,0.448,21,27,0.778,1,56,57,78,14,2,33,37,193
2001-2002,Brent Barry\barrybr01,SG,30,SEA,81,81,3040,401,790,0.508,164,387,0.424,237,403,0.588,0.611,198,234,0.846,58,383,441,426,147,37,165,182,1164
2001-2002,Jon Barry\barryjo01,SG,32,DET,82,6,1985,255,522,0.489,121,258,0.469,134,264,0.508,0.604,108,116,0.931,42,192,234,274,94,20,111,134,739
2001-2002,Mengke Bateer\bateeme01,C,26,DEN,27,10,408,53,132,0.402,4,12,0.333,49,120,0.408,0.417,29,37,0.784,32,64,96,22,10,5,32,94,139
2001-2002,Tony Battie\battito01,C,25,BOS,74,73,1819,211,390,0.541,0,2,0,211,388,0.544,0.541,88,130,0.677,184,297,481,35,60,67,51,219,510
2001-2002,Shane Battier\battish01,SF,23,MEM,78,78,3097,412,961,0.429,103,276,0.373,309,685,0.451,0.482,198,283,0.7,180,238,418,216,121,81,155,215,1125
2001-2002,Charlie Bell\bellch01,SG,22,TOT,7,0,44,3,11,0.273,0,6,0,3,5,0.6,0.273,2,2,1,2,3,5,2,0,0,5,3,8
2001-2002,Charlie Bell\bellch01,SG,22,PHO,5,0,42,3,11,0.273,0,6,0,3,5,0.6,0.273,2,2,1,2,2,4,2,0,0,5,3,8
2001-2002,Charlie Bell\bellch01,SG,22,DAL,2,0,2,0,0,,0,0,,0,0,,,0,0,,0,1,1,0,0,0,0,0,0
2001-2002,Raja Bell\bellra01,SG,25,PHI,74,12,890,103,240,0.429,12,44,0.273,91,196,0.464,0.454,36,48,0.75,31,80,111,71,21,4,48,109,254
2001-2002,Jonathan Bender\bendejo01,SF,21,IND,78,17,1647,198,460,0.43,45,125,0.36,153,335,0.457,0.479,140,181,0.773,64,180,244,62,19,49,96,147,581
2001-2002,Travis Best\besttr01,PG,29,TOT,74,21,1747,228,518,0.44,21,59,0.356,207,459,0.451,0.46,104,116,0.897,20,131,151,324,89,7,99,173,581
2001-2002,Travis Best\besttr01,PG,29,IND,44,3,954,116,264,0.439,13,34,0.382,103,230,0.448,0.464,57,65,0.877,10,60,70,175,57,6,59,101,302
2001-2002,Travis Best\besttr01,PG,29,CHI,30,18,793,112,254,0.441,8,25,0.32,104,229,0.454,0.457,47,51,0.922,10,71,81,149,32,1,40,72,279
2001-2002,Mike Bibby\bibbymi01,PG,23,SAC,80,80,2659,446,985,0.453,51,138,0.37,395,847,0.466,0.479,155,193,0.803,37,185,222,403,87,15,134,133,1098
2001-2002,Chauncey Billups\billuch01,PG,25,MIN,82,54,2355,348,823,0.423,124,315,0.394,224,508,0.441,0.498,207,234,0.885,35,191,226,450,66,17,138,169,1027
2001-2002,Mookie Blaylock\blaylmo01,PG,34,GSW,35,0,599,50,146,0.342,15,42,0.357,35,104,0.337,0.394,4,8,0.5,8,44,52,114,24,4,37,20,119
2001-2002,Corie Blount\blounco01,PF,33,PHI,72,21,1426,115,251,0.458,0,1,0,115,250,0.46,0.458,29,45,0.644,149,219,368,44,49,26,52,176,259
2001-2002,Mark Blount\blounma01,C,26,BOS,44,0,415,32,76,0.421,0,0,,32,76,0.421,0.421,30,37,0.811,26,59,85,10,16,19,23,59,94
2001-2002,Calvin Booth\boothca01,C,25,SEA,15,15,279,35,82,0.427,0,0,,35,82,0.427,0.427,23,24,0.958,20,34,54,16,6,13,16,47,93
2001-2002,Ruben Boumtje-Boumtje\boumtru01,C,23,POR,33,1,245,13,32,0.406,0,0,,13,32,0.406,0.406,13,25,0.52,21,34,55,4,3,16,14,38,39
2001-2002,Cal Bowdler\bowdlca01,PF,24,ATL,52,0,585,61,174,0.351,1,5,0.2,60,169,0.355,0.353,39,47,0.83,38,72,110,11,18,15,11,64,162
2001-2002,Bruce Bowen\bowenbr01,SF,30,SAS,59,59,1699,155,398,0.389,56,148,0.378,99,250,0.396,0.46,46,96,0.479,42,120,162,88,62,25,66,116,412
2001-2002,Ryan Bowen\bowenry01,SF,26,DEN,75,21,1686,147,307,0.479,1,12,0.083,146,295,0.495,0.48,69,92,0.75,134,165,299,52,75,41,41,171,364
2001-2002,Ira Bowman\bowmair01,SG,28,PHI,3,0,29,5,7,0.714,0,1,0,5,6,0.833,0.714,0,0,,0,1,1,1,2,0,0,3,10
2001-2002,Earl Boykins\boykiea01,PG,25,LAC,68,2,761,110,275,0.4,13,42,0.31,97,233,0.416,0.424,47,61,0.77,27,27,54,145,20,2,44,44,280
2001-2002,Michael Bradley\bradlmi01,PF,22,TOR,26,0,118,13,25,0.52,0,2,0,13,23,0.565,0.52,4,8,0.5,7,17,24,3,0,6,6,10,30
2001-2002,Shawn Bradley\bradlsh01,C,29,DAL,53,16,757,78,163,0.479,0,1,0,78,162,0.481,0.479,59,64,0.922,53,123,176,20,28,64,25,128,215
2001-2002,Elton Brand\brandel01,PF,22,LAC,80,80,3020,532,1010,0.527,0,0,,532,1010,0.527,0.527,389,524,0.742,396,529,925,191,80,163,173,254,1453
2001-2002,Terrell Brandon\brandte01,PG,31,MIN,32,28,962,155,365,0.425,4,23,0.174,151,342,0.442,0.43,83,84,0.988,17,76,93,264,52,6,43,49,397
2001-2002,Jamison Brewer\breweja01,SG,21,IND,13,0,43,2,5,0.4,0,1,0,2,4,0.5,0.4,0,0,,2,6,8,9,2,0,3,3,4
2001-2002,Primoz Brezec\brezepr01,C,22,IND,22,4,160,14,29,0.483,0,0,,14,29,0.483,0.483,15,25,0.6,16,12,28,6,0,7,6,28,43
2001-2002,Chucky Brown\brownch01,SF,33,SAC,18,0,92,10,27,0.37,0,0,,10,27,0.37,0.37,1,2,0.5,10,23,33,6,2,4,5,12,21
2001-2002,Damone Brown\brownda02,SF,22,PHI,17,0,67,8,21,0.381,0,1,0,8,20,0.4,0.381,7,8,0.875,2,2,4,2,1,1,9,11,23
2001-2002,Dee Brown\brownde01,PG,33,ORL,7,0,65,3,20,0.15,1,12,0.083,2,8,0.25,0.175,0,0,,0,9,9,2,3,1,4,4,7
2001-2002,Ernest Brown\browner01,C,22,MIA,3,0,21,1,6,0.167,0,0,,1,6,0.167,0.167,1,4,0.25,1,5,6,0,0,1,3,4,3
2001-2002,Kedrick Brown\brownke01,SF,20,BOS,29,5,245,23,70,0.329,5,27,0.185,18,43,0.419,0.364,12,20,0.6,11,39,50,15,18,7,7,18,63
2001-2002,Kwame Brown\brownkw01,PF,19,WAS,57,3,817,94,243,0.387,0,1,0,94,242,0.388,0.387,70,99,0.707,63,135,198,43,16,26,43,105,258
2001-2002,P.J. Brown\brownpj01,C,32,CHH,80,80,2563,250,527,0.474,0,0,,250,527,0.474,0.474,169,197,0.858,273,513,786,107,59,78,85,222,669
2001-2002,Randy Brown\brownra02,PG,33,BOS,1,0,6,0,1,0,0,0,,0,1,0,0,0,0,,0,0,0,2,0,1,0,1,0
2001-2002,Tierre Brown\brownti01,SG,22,HOU,40,1,403,49,115,0.426,4,12,0.333,45,103,0.437,0.443,21,28,0.75,12,30,42,70,19,3,40,26,123
2001-2002,Rick Brunson\brunsri01,PG,29,POR,59,2,520,45,113,0.398,6,11,0.545,39,102,0.382,0.425,29,41,0.707,23,45,68,114,25,2,47,51,125
2001-2002,Kobe Bryant\bryanko01,SG,23,LAL,80,80,3063,749,1597,0.469,33,132,0.25,716,1465,0.489,0.479,488,589,0.829,112,329,441,438,118,35,223,228,2019
2001-2002,Mark Bryant\bryanma01,PF,36,SAS,30,3,206,25,55,0.455,0,0,,25,55,0.455,0.455,6,8,0.75,25,19,44,10,7,2,6,38,56
2001-2002,Greg Buckner\buckngr01,SG,25,DAL,44,16,885,104,198,0.525,5,16,0.313,99,182,0.544,0.538,40,58,0.69,67,106,173,48,31,19,27,124,253
2001-2002,Jud Buechler\buechju01,SF,33,TOT,66,2,684,44,118,0.373,21,60,0.35,23,58,0.397,0.462,2,4,0.5,29,87,116,32,21,8,15,53,111
2001-2002,Jud Buechler\buechju01,SF,33,PHO,6,0,54,2,6,0.333,2,6,0.333,0,0,,0.5,0,0,,2,6,8,3,1,0,1,7,6
2001-2002,Jud Buechler\buechju01,SF,33,ORL,60,2,630,42,112,0.375,19,54,0.352,23,58,0.397,0.46,2,4,0.5,27,81,108,29,20,8,14,46,105
2001-2002,Rodney Buford\buforro01,SG,24,MEM,63,21,1769,258,593,0.435,17,70,0.243,241,523,0.461,0.449,58,80,0.725,52,220,272,71,42,12,63,110,591
2001-2002,Matt Bullard\bullama01,PF,34,CHH,31,0,350,39,115,0.339,16,57,0.281,23,58,0.397,0.409,11,12,0.917,10,37,47,16,2,2,12,29,105
2001-2002,Mitchell Butler\butlemi02,SG,31,POR,11,0,90,10,23,0.435,1,3,0.333,9,20,0.45,0.457,8,12,0.667,6,8,14,5,0,1,5,10,29
2001-2002,Jason Caffey\caffeja01,PF,28,MIL,23,0,283,36,72,0.5,0,1,0,36,71,0.507,0.5,27,43,0.628,24,26,50,12,4,5,19,39,99
2001-2002,Marcus Camby\cambyma01,C,27,NYK,29,29,1007,130,290,0.448,0,1,0,130,289,0.45,0.448,62,99,0.626,89,233,322,33,34,50,42,107,322
2001-2002,Elden Campbell\campbel01,PF,33,CHH,77,74,2156,384,794,0.484,0,2,0,384,792,0.485,0.484,306,384,0.797,133,397,530,102,60,137,138,264,1074
2001-2002,Brian Cardinal\cardibr01,PF,24,DET,8,0,43,6,13,0.462,3,7,0.429,3,6,0.5,0.577,2,2,1,2,4,6,2,1,0,0,5,17
2001-2002,Anthony Carter\cartean01,PG,26,MIA,46,18,1050,89,260,0.342,1,19,0.053,88,241,0.365,0.344,19,36,0.528,19,98,117,214,50,3,72,85,198
2001-2002,Vince Carter\cartevi01,SG,25,TOR,60,60,2385,559,1307,0.428,121,313,0.387,438,994,0.441,0.474,245,307,0.798,138,175,313,239,94,43,154,191,1484
2001-2002,Sam Cassell\cassesa01,PG,32,MIL,74,73,2605,554,1197,0.463,71,204,0.348,483,993,0.486,0.492,282,328,0.86,54,258,312,493,90,12,177,208,1461
2001-2002,Kelvin Cato\catoke01,C,27,HOU,75,73,1917,190,326,0.583,0,1,0,190,325,0.585,0.583,113,194,0.582,176,349,525,29,40,95,53,208,493
2001-2002,Tyson Chandler\chandty01,C,19,CHI,71,31,1389,151,304,0.497,0,0,,151,304,0.497,0.497,134,222,0.604,114,229,343,54,28,93,99,179,436
2001-2002,Calbert Cheaney\cheanca01,SG,30,DEN,68,47,1631,224,466,0.481,0,4,0,224,462,0.485,0.481,46,67,0.687,57,183,240,110,34,21,70,156,494
2001-2002,Chris Childs\childch01,PG,34,TOR,69,4,1576,97,296,0.328,33,120,0.275,64,176,0.364,0.383,58,71,0.817,18,136,154,351,56,5,123,177,285
2001-2002,Doug Christie\chrisdo01,SG,31,SAC,81,81,2798,338,735,0.46,90,256,0.352,248,479,0.518,0.521,206,242,0.851,74,300,374,340,160,25,164,209,972
2001-2002,Keon Clark\clarkke01,C,26,TOR,81,31,2185,380,775,0.49,0,5,0,380,770,0.494,0.49,155,230,0.674,182,421,603,88,58,122,140,258,915
2001-2002,Speedy Claxton\claxtsp01,PG,23,PHI,67,18,1528,181,452,0.4,4,33,0.121,177,419,0.422,0.405,114,136,0.838,46,114,160,198,95,6,95,145,480
2001-2002,Mateen Cleaves\cleavma01,PG,24,SAC,32,0,153,30,68,0.441,2,8,0.25,28,60,0.467,0.456,8,9,0.889,1,7,8,25,7,0,27,9,70
2001-2002,Derrick Coleman\colemde01,PF,34,PHI,58,58,2080,331,735,0.45,28,83,0.337,303,652,0.465,0.469,185,227,0.815,167,342,509,98,42,51,119,158,875
2001-2002,Bimbo Coles\colesbi01,PG,33,CLE,47,1,693,56,146,0.384,4,20,0.2,52,126,0.413,0.397,33,37,0.892,12,43,55,107,13,4,31,59,149
2001-2002,Jason Collier\collija02,C,24,HOU,25,2,365,41,95,0.432,0,1,0,41,94,0.436,0.432,24,32,0.75,31,51,82,9,6,4,13,40,106
2001-2002,Jarron Collins\collija03,C,23,UTA,70,68,1440,158,343,0.461,0,1,0,158,342,0.462,0.461,134,181,0.74,138,158,296,58,29,22,56,234,450
2001-2002,Jason Collins\collija04,C,23,NJN,77,9,1407,117,278,0.421,1,2,0.5,116,276,0.42,0.423,115,164,0.701,132,169,301,81,29,47,72,173,350
2001-2002,Chris Crawford\crawfch01,PF,26,ATL,7,4,131,21,45,0.467,0,1,0,21,44,0.477,0.467,11,15,0.733,9,16,25,5,2,5,10,21,53
2001-2002,Jamal Crawford\crawfja01,PG,21,CHI,23,6,481,89,187,0.476,26,58,0.448,63,129,0.488,0.545,10,13,0.769,5,29,34,55,18,5,32,18,214
2001-2002,Joe Crispin\crispjo01,PG,22,TOT,21,0,156,26,68,0.382,15,39,0.385,11,29,0.379,0.493,12,13,0.923,2,9,11,26,5,0,10,10,79
2001-2002,Joe Crispin\crispjo01,PG,22,LAL,6,0,27,3,12,0.25,0,4,0,3,8,0.375,0.25,4,5,0.8,0,1,1,2,1,0,1,2,10
2001-2002,Joe Crispin\crispjo01,PG,22,PHO,15,0,129,23,56,0.411,15,35,0.429,8,21,0.381,0.545,8,8,1,2,8,10,24,4,0,9,8,69
2001-2002,Austin Croshere\croshau01,PF,26,IND,76,1,1286,185,448,0.413,49,145,0.338,136,303,0.449,0.468,97,114,0.851,74,220,294,77,26,29,67,106,516
2001-2002,John Crotty\crottjo01,PG,32,UTA,41,0,802,98,208,0.471,31,69,0.449,67,139,0.482,0.546,57,66,0.864,16,59,75,141,19,1,51,77,284
2001-2002,Vonteego Cummings\cummivo01,PG,25,PHI,58,1,501,78,187,0.417,12,46,0.261,66,141,0.468,0.449,24,32,0.75,14,38,52,60,18,5,36,53,192
2001-2002,Dell Curry\curryde01,SG,37,TOR,56,4,886,141,347,0.406,45,131,0.344,96,216,0.444,0.471,33,37,0.892,23,58,81,61,22,6,41,50,360
2001-2002,Eddy Curry\curryed01,C,19,CHI,72,31,1150,189,377,0.501,0,0,,189,377,0.501,0.501,105,160,0.656,111,161,272,25,16,53,69,173,483
2001-2002,Michael Curry\currymi01,SG,33,DET,82,75,1912,125,276,0.453,7,26,0.269,118,250,0.472,0.466,72,91,0.791,15,153,168,127,47,10,60,207,329
2001-2002,Samuel Dalembert\dalemsa01,C,20,PHI,34,0,177,22,50,0.44,0,0,,22,50,0.44,0.44,7,18,0.389,25,43,68,5,6,13,14,30,51
2001-2002,Erick Dampier\dampier01,C,26,GSW,73,46,1740,209,480,0.435,0,0,,209,480,0.435,0.435,136,211,0.645,167,220,387,87,17,167,156,235,554
2001-2002,Antonio Daniels\daniean01,SG,26,SAS,82,13,2175,269,612,0.44,57,196,0.291,212,416,0.51,0.486,158,210,0.752,23,153,176,228,48,12,70,104,753
2001-2002,Antonio Davis\davisan01,PF,33,TOR,77,77,2978,410,963,0.426,0,1,0,410,962,0.426,0.426,293,358,0.818,254,486,740,155,54,83,159,225,1113
2001-2002,Baron Davis\davisba01,PG,22,CHH,82,82,3318,559,1341,0.417,170,478,0.356,389,863,0.451,0.48,196,338,0.58,93,256,349,698,172,47,246,241,1484
2001-2002,Dale Davis\davisda01,C,32,POR,78,77,2447,296,580,0.51,0,0,,296,580,0.51,0.51,150,212,0.708,262,426,688,96,62,83,62,193,742
2001-2002,Emanual Davis\davisem01,PG,33,ATL,28,20,774,70,198,0.354,29,85,0.341,41,113,0.363,0.427,16,18,0.889,19,55,74,68,27,5,52,68,185
2001-2002,Hubert Davis\davishu01,SG,31,WAS,51,17,1231,146,326,0.448,57,126,0.452,89,200,0.445,0.535,16,21,0.762,7,70,77,107,28,3,44,58,365
2001-2002,Ricky Davis\davisri01,SF,22,CLE,82,8,1954,376,781,0.481,11,35,0.314,365,746,0.489,0.488,196,248,0.79,63,180,243,178,69,23,148,145,959
2001-2002,Andrew DeClercq\declean01,C,28,ORL,61,14,633,67,149,0.45,0,0,,67,149,0.45,0.45,28,50,0.56,74,89,163,22,23,24,34,130,162
2001-2002,Vinny Del Negro\delnevi01,PG,35,PHO,2,0,6,1,4,0.25,0,0,,1,4,0.25,0.25,0,0,,0,0,0,2,0,0,0,0,2
2001-2002,Tony Delk\delkto01,SG,28,TOT,63,17,1447,226,588,0.384,67,214,0.313,159,374,0.425,0.441,78,97,0.804,58,145,203,132,53,10,59,98,597
2001-2002,Tony Delk\delkto01,SG,28,PHO,41,1,877,166,416,0.399,47,147,0.32,119,269,0.442,0.456,56,67,0.836,38,86,124,81,31,4,40,60,435
2001-2002,Tony Delk\delkto01,SG,28,BOS,22,16,570,60,172,0.349,20,67,0.299,40,105,0.381,0.407,22,30,0.733,20,59,79,51,22,6,19,38,162
2001-2002,Derrick Dial\dialde01,SG,26,TOT,32,0,299,41,120,0.342,1,11,0.091,40,109,0.367,0.346,18,24,0.75,14,42,56,35,10,4,16,13,101
2001-2002,Derrick Dial\dialde01,SG,26,NJN,25,0,249,30,94,0.319,0,7,0,30,87,0.345,0.319,13,18,0.722,12,33,45,31,8,4,13,12,73
2001-2002,Derrick Dial\dialde01,SG,26,TOR,7,0,50,11,26,0.423,1,4,0.25,10,22,0.455,0.442,5,6,0.833,2,9,11,4,2,0,3,1,28
2001-2002,Michael Dickerson\dickemi01,SG,26,MEM,4,4,124,15,48,0.313,8,21,0.381,7,27,0.259,0.396,5,6,0.833,3,9,12,9,3,1,8,12,43
2001-2002,DeSagana Diop\diopde01,C,20,CLE,18,1,109,12,29,0.414,0,0,,12,29,0.414,0.414,1,5,0.2,5,12,17,5,1,10,12,19,25
2001-2002,Vlade Divac\divacvl01,C,33,SAC,80,80,2420,338,716,0.472,3,13,0.231,335,703,0.477,0.474,209,340,0.615,205,466,671,297,79,94,158,229,888
2001-2002,Michael Doleac\doleami01,C,24,CLE,42,15,705,78,187,0.417,0,0,,78,187,0.417,0.417,38,46,0.826,47,121,168,25,15,11,37,98,194
2001-2002,Keyon Dooling\doolike01,PG,21,LAC,14,0,155,22,57,0.386,4,14,0.286,18,43,0.419,0.421,10,12,0.833,0,3,3,12,4,3,10,20,58
2001-2002,Bryce Drew\drewbr01,PG,27,CHH,61,0,774,78,182,0.429,31,73,0.425,47,109,0.431,0.514,23,29,0.793,14,58,72,101,32,2,33,49,210
2001-2002,Predrag Drobnjak\drobnpr01,C,26,SEA,64,12,1174,191,414,0.461,0,2,0,191,412,0.464,0.461,55,73,0.753,75,144,219,51,20,31,51,109,437
2001-2002,Chris Dudley\dudlech02,C,36,POR,43,2,327,20,50,0.4,0,2,0,20,48,0.417,0.4,8,15,0.533,27,53,80,13,3,14,14,42,48
2001-2002,Tim Duncan\duncati01,PF,25,SAS,82,82,3329,764,1504,0.508,1,10,0.1,763,1494,0.511,0.508,560,701,0.799,268,774,1042,307,61,203,263,217,2089
2001-2002,Howard Eisley\eisleho01,PG,29,NYK,39,0,609,59,175,0.337,14,58,0.241,45,117,0.385,0.377,39,49,0.796,9,40,49,100,24,3,53,55,171
2001-2002,Obinna Ekezie\ekeziob01,PF,26,LAC,29,1,152,13,39,0.333,0,0,,13,39,0.333,0.333,28,40,0.7,12,22,34,3,2,6,10,16,54
2001-2002,LaPhonso Ellis\ellisla01,SF,31,MIA,66,14,1684,189,452,0.418,38,124,0.306,151,328,0.46,0.46,53,84,0.631,107,180,287,56,30,37,73,196,469
2001-2002,Evan Eschmeyer\eschmev01,C,26,DAL,31,6,299,21,50,0.42,0,0,,21,50,0.42,0.42,20,33,0.606,35,63,98,9,10,9,16,60,62
2001-2002,Maurice Evans\evansma01,SG,23,MIN,10,0,45,9,19,0.474,0,3,0,9,16,0.563,0.474,3,4,0.75,3,1,4,4,0,0,2,9,21
2001-2002,Patrick Ewing*\ewingpa01,C,39,ORL,65,4,901,148,333,0.444,0,1,0,148,332,0.446,0.444,94,134,0.701,60,203,263,35,22,45,65,129,390
2001-2002,Danny Ferry\ferryda01,SF,35,SAS,50,2,799,76,177,0.429,43,99,0.434,33,78,0.423,0.551,34,36,0.944,15,75,90,48,16,9,22,70,229
2001-2002,Michael Finley\finlemi01,SF,28,DAL,69,69,2754,569,1228,0.463,76,224,0.339,493,1004,0.491,0.494,210,251,0.837,90,270,360,230,65,25,117,144,1424
2001-2002,Derek Fisher\fishede01,PG,27,LAL,70,35,1974,274,666,0.411,144,349,0.413,130,317,0.41,0.52,94,111,0.847,15,131,146,181,66,9,62,121,786
2001-2002,Marcus Fizer\fizerma01,PF,23,CHI,76,20,1963,371,848,0.438,7,41,0.171,364,807,0.451,0.442,189,283,0.668,128,299,427,120,49,24,131,186,938
2001-2002,Isaac Fontaine\fontais01,SG,26,MEM,6,0,75,3,14,0.214,1,5,0.2,2,9,0.222,0.25,4,6,0.667,0,5,5,4,0,0,4,6,11
2001-2002,Alton Ford\fordal02,PF,20,PHO,53,0,452,61,118,0.517,0,0,,61,118,0.517,0.517,42,57,0.737,32,75,107,7,6,7,32,99,164
2001-2002,Joseph Forte\fortejo01,SG,20,BOS,8,0,39,1,12,0.083,0,3,0,1,9,0.111,0.083,4,4,1,1,5,6,6,2,0,3,1,6
2001-2002,Danny Fortson\fortsda01,PF,25,GSW,77,76,2216,309,722,0.428,1,4,0.25,308,718,0.429,0.429,245,308,0.795,290,609,899,127,44,17,160,255,864
2001-2002,Greg Foster\fostegr01,PF,33,MIL,6,0,24,2,9,0.222,0,4,0,2,5,0.4,0.222,3,4,0.75,0,8,8,1,0,0,0,4,7
2001-2002,Jeff Foster\fosteje01,C,25,IND,82,48,1786,177,394,0.449,2,15,0.133,175,379,0.462,0.452,111,182,0.61,206,350,556,70,71,38,79,232,467
2001-2002,Antonis Fotsis\fotsian01,PF,20,MEM,28,1,320,42,104,0.404,7,23,0.304,35,81,0.432,0.438,17,20,0.85,25,37,62,10,9,11,21,22,108
2001-2002,Tremaine Fowlkes\fowlktr01,SF,25,LAC,22,17,343,25,64,0.391,0,0,,25,64,0.391,0.391,24,31,0.774,32,32,64,17,11,1,13,39,74
2001-2002,Rick Fox\foxri01,SF,32,LAL,82,82,2289,255,605,0.421,65,208,0.313,190,397,0.479,0.475,70,85,0.824,90,299,389,283,67,21,132,244,645
2001-2002,Adonal Foyle\foylead01,C,26,GSW,79,36,1485,171,385,0.444,0,0,,171,385,0.444,0.444,37,93,0.398,150,234,384,41,36,168,76,179,379
2001-2002,Steve Francis\francst01,PG,24,HOU,57,56,2343,420,1007,0.417,68,210,0.324,352,797,0.442,0.451,326,422,0.773,102,299,401,362,71,25,221,172,1234
2001-2002,Lawrence Funderburke\fundela01,PF,31,SAC,56,1,722,115,245,0.469,0,3,0,115,242,0.475,0.469,34,56,0.607,76,122,198,32,11,18,33,65,264
2001-2002,Kevin Garnett\garneke01,PF,25,MIN,81,81,3175,659,1401,0.47,37,116,0.319,622,1285,0.484,0.484,359,448,0.801,243,738,981,422,96,126,229,184,1714
2001-2002,Dean Garrett\garrede01,C,35,TOT,34,0,183,18,55,0.327,0,0,,18,55,0.327,0.327,0,3,0,16,41,57,5,7,10,10,32,36
2001-2002,Dean Garrett\garrede01,C,35,MIN,29,0,152,14,40,0.35,0,0,,14,40,0.35,0.35,0,3,0,13,34,47,4,5,9,7,26,28
2001-2002,Dean Garrett\garrede01,C,35,GSW,5,0,31,4,15,0.267,0,0,,4,15,0.267,0.267,0,0,,3,7,10,1,2,1,3,6,8
2001-2002,Pat Garrity\garripa01,PF,25,ORL,80,43,2406,327,767,0.426,169,396,0.427,158,371,0.426,0.537,61,73,0.836,77,261,338,99,61,28,68,230,884
2001-2002,Pau Gasol\gasolpa01,C,21,MEM,82,79,3007,551,1064,0.518,1,5,0.2,550,1059,0.519,0.518,338,477,0.709,238,492,730,223,41,169,224,195,1441
2001-2002,Chris Gatling\gatlich01,PF,34,MIA,54,1,809,131,293,0.447,1,8,0.125,130,285,0.456,0.449,82,117,0.701,71,135,206,25,17,11,58,109,345
2001-2002,Matt Geiger\geigema01,C,32,PHI,4,0,36,1,8,0.125,0,0,,1,8,0.125,0.125,1,2,0.5,3,3,6,0,0,2,2,2,3
2001-2002,Devean George\georgde01,SF,24,LAL,82,1,1759,215,523,0.411,66,178,0.371,149,345,0.432,0.474,85,126,0.675,78,225,303,111,71,42,66,190,581
2001-2002,Eddie Gill\gilled01,PG,23,MEM,23,5,384,39,92,0.424,7,22,0.318,32,70,0.457,0.462,31,39,0.795,7,21,28,49,11,3,34,38,116
2001-2002,Kendall Gill\gillke01,SG,33,MIA,65,49,1410,162,422,0.384,6,44,0.136,156,378,0.413,0.391,42,62,0.677,29,155,184,100,44,8,55,140,372
2001-2002,Dion Glover\glovedi01,SG,23,ATL,55,25,1156,192,456,0.421,30,91,0.33,162,365,0.444,0.454,78,103,0.757,36,133,169,84,45,14,76,89,492
2001-2002,Steve Goodrich\goodrst01,SF,25,NJN,9,0,50,2,10,0.2,0,0,,2,10,0.2,0.2,1,2,0.5,1,4,5,5,1,2,3,10,5
2001-2002,Brian Grant\grantbr01,PF,29,MIA,72,72,2256,286,610,0.469,0,2,0,286,608,0.47,0.469,101,119,0.849,168,407,575,137,48,31,122,236,673
2001-2002,Horace Grant\grantho01,C,36,ORL,76,76,2210,264,515,0.513,0,0,,264,515,0.513,0.513,80,111,0.721,159,322,481,104,57,49,51,118,608
2001-2002,Adrian Griffin\griffad01,SG,27,DAL,58,34,1383,179,359,0.499,16,54,0.296,163,305,0.534,0.521,41,49,0.837,68,161,229,106,75,12,42,142,415
2001-2002,Eddie Griffin\griffed01,PF,19,HOU,73,24,1896,244,666,0.366,90,273,0.33,154,393,0.392,0.434,64,86,0.744,117,299,416,53,17,134,47,117,642
2001-2002,Tom Gugliotta\guglito01,PF,32,PHO,44,40,1129,127,301,0.422,3,9,0.333,124,292,0.425,0.427,28,37,0.757,59,162,221,77,39,30,61,116,285
2001-2002,A.J. Guyton\guytoaj01,PG,23,CHI,45,6,607,88,244,0.361,46,123,0.374,42,121,0.347,0.455,22,27,0.815,12,32,44,81,10,7,37,23,244
2001-2002,Darvin Ham\hamda01,SF,28,MIL,70,2,1208,120,211,0.569,1,7,0.143,119,204,0.583,0.571,62,123,0.504,91,111,202,73,25,37,83,175,303
2001-2002,Richard Hamilton\hamilri01,SG,23,WAS,63,57,2203,472,1084,0.435,16,42,0.381,456,1042,0.438,0.443,300,337,0.89,73,143,216,171,38,14,132,136,1260
2001-2002,Tang Hamilton\hamilta01,SF,23,MIA,9,2,98,10,19,0.526,0,1,0,10,18,0.556,0.526,0,1,0,6,12,18,5,4,0,2,10,20
2001-2002,Zendon Hamilton\hamilze01,PF,26,DEN,54,15,848,103,245,0.42,0,0,,103,245,0.42,0.42,118,181,0.652,110,143,253,14,21,18,60,104,324
2001-2002,Anfernee Hardaway\hardaan01,SG,30,PHO,80,55,2462,389,931,0.418,23,83,0.277,366,848,0.432,0.43,158,195,0.81,98,252,350,324,122,32,189,184,959
2001-2002,Tim Hardaway\hardati01,PG,35,TOT,68,16,1601,226,620,0.365,123,354,0.347,103,266,0.387,0.464,77,97,0.794,14,110,124,278,57,10,111,109,652
2001-2002,Tim Hardaway\hardati01,PG,35,DAL,54,2,1276,179,494,0.362,95,279,0.341,84,215,0.391,0.459,65,78,0.833,13,84,97,201,40,8,73,84,518
2001-2002,Tim Hardaway\hardati01,PG,35,DEN,14,14,325,47,126,0.373,28,75,0.373,19,51,0.373,0.484,12,19,0.632,1,26,27,77,17,2,38,25,134
2001-2002,Matt Harpring\harprma01,SF,25,PHI,81,81,2541,386,838,0.461,21,69,0.304,365,769,0.475,0.473,165,222,0.743,203,370,573,107,70,5,127,201,958
2001-2002,Al Harrington\harrial01,PF,21,IND,44,1,1313,230,484,0.475,1,3,0.333,229,481,0.476,0.476,115,144,0.799,96,180,276,54,41,21,78,166,576
2001-2002,Othella Harrington\harriot01,PF,28,NYK,77,4,1563,237,450,0.527,0,2,0,237,448,0.529,0.527,122,172,0.709,125,224,349,37,30,36,95,250,596
2001-2002,Lucious Harris\harrilu01,SG,31,NJN,74,0,1553,249,537,0.464,44,118,0.373,205,419,0.489,0.505,133,158,0.842,49,158,207,116,53,6,61,99,675
2001-2002,Jason Hart\hartja01,PG,23,SAS,10,0,92,10,19,0.526,0,2,0,10,17,0.588,0.526,6,6,1,4,9,13,12,7,1,8,16,26
2001-2002,Antonio Harvey\harvean01,PF,31,SEA,5,3,47,4,12,0.333,0,0,,4,12,0.333,0.333,1,2,0.5,5,4,9,5,1,3,3,8,9
2001-2002,Donnell Harvey\harvedo01,PF,21,TOT,47,4,841,108,217,0.498,0,0,,108,217,0.498,0.498,54,90,0.6,80,147,227,37,21,24,33,115,270
2001-2002,Donnell Harvey\harvedo01,PF,21,DAL,18,0,162,14,26,0.538,0,0,,14,26,0.538,0.538,10,22,0.455,12,34,46,5,4,5,8,27,38
2001-2002,Donnell Harvey\harvedo01,PF,21,DEN,29,4,679,94,191,0.492,0,0,,94,191,0.492,0.492,44,68,0.647,68,113,181,32,17,19,25,88,232
2001-2002,Trenton Hassell\hassetr01,SG,22,CHI,78,47,2237,267,628,0.425,60,165,0.364,207,463,0.447,0.473,87,114,0.763,65,190,255,172,55,44,101,184,681
2001-2002,Kirk Haston\hastoki01,PF,22,CHH,15,0,77,11,39,0.282,0,3,0,11,36,0.306,0.282,4,8,0.5,5,15,20,5,0,1,3,9,26
2001-2002,Brendan Haywood\haywobr01,C,22,WAS,62,2,1266,109,221,0.493,0,0,,109,221,0.493,0.493,97,160,0.606,143,179,322,29,21,91,50,158,315
2001-2002,Alan Henderson\hendeal01,PF,29,ATL,26,1,422,59,116,0.509,1,1,1,58,115,0.504,0.513,24,45,0.533,31,66,97,11,11,15,21,40,143
2001-2002,Cedric Henderson\hendece02,SF,26,GSW,12,0,70,15,31,0.484,2,4,0.5,13,27,0.481,0.516,4,7,0.571,1,2,3,4,6,2,8,4,36
2001-2002,Grant Hill\hillgr01,SF,29,ORL,14,14,512,83,195,0.426,0,2,0,83,193,0.43,0.426,69,80,0.863,29,96,125,64,8,4,37,40,235
2001-2002,Tyrone Hill\hillty01,PF,33,CLE,26,26,810,71,182,0.39,0,1,0,71,181,0.392,0.39,67,103,0.65,79,195,274,23,17,13,48,102,209
2001-2002,Fred Hoiberg\hoibefr01,SG,29,CHI,79,8,1408,121,291,0.416,24,92,0.261,97,199,0.487,0.457,79,94,0.84,18,192,210,136,61,5,32,87,345
2001-2002,Robert Horry\horryro01,PF,31,LAL,81,23,2140,183,460,0.398,76,203,0.374,107,257,0.416,0.48,108,138,0.783,130,349,479,232,77,89,88,208,550
2001-2002,Eddie House\houseed01,PG,23,MIA,64,3,1230,209,524,0.399,54,157,0.344,155,367,0.422,0.45,42,49,0.857,17,93,110,123,43,5,80,98,514
2001-2002,Allan Houston\houstal01,SG,30,NYK,77,77,2914,568,1301,0.437,136,346,0.393,432,955,0.452,0.489,295,339,0.87,37,215,252,190,54,10,170,182,1567
2001-2002,Juwan Howard\howarju01,PF,28,TOT,81,72,2635,462,1005,0.46,0,2,0,462,1003,0.461,0.46,261,343,0.761,223,389,612,169,46,47,152,265,1185
2001-2002,Juwan Howard\howarju01,PF,28,DAL,53,44,1659,270,585,0.462,0,1,0,270,584,0.462,0.462,144,191,0.754,138,252,390,93,28,30,78,170,684
2001-2002,Juwan Howard\howarju01,PF,28,DEN,28,28,976,192,420,0.457,0,1,0,192,419,0.458,0.457,117,152,0.77,85,137,222,76,18,17,74,95,501
2001-2002,Troy Hudson\hudsotr01,PG,25,ORL,81,4,1854,354,815,0.434,66,187,0.353,288,628,0.459,0.475,176,201,0.876,30,115,145,255,57,6,163,119,950
2001-2002,Larry Hughes\hughela01,SG,23,GSW,73,56,2049,343,810,0.423,18,93,0.194,325,717,0.453,0.435,191,259,0.737,83,162,245,316,113,23,171,150,895
2001-2002,Lindsey Hunter\hunteli01,PG,31,LAL,82,47,1616,187,490,0.382,79,208,0.38,108,282,0.383,0.462,20,40,0.5,18,103,121,129,66,19,55,120,473
2001-2002,Steven Hunter\huntest01,C,20,ORL,53,21,516,67,147,0.456,0,0,,67,147,0.456,0.456,55,94,0.585,40,57,97,5,5,43,16,81,189
2001-2002,Zydrunas Ilgauskas\ilgauzy01,C,26,CLE,62,23,1329,241,567,0.425,0,5,0,241,562,0.429,0.425,208,276,0.754,136,198,334,70,17,84,94,187,690
2001-2002,Allen Iverson*\iversal01,SG,26,PHI,60,59,2622,665,1669,0.398,78,268,0.291,587,1401,0.419,0.422,475,585,0.812,44,225,269,331,168,13,237,102,1883
2001-2002,Bobby Jackson\jacksbo01,PG,28,SAC,81,3,1750,334,754,0.443,79,219,0.361,255,535,0.477,0.495,149,184,0.81,82,169,251,164,73,11,93,145,896
2001-2002,Jaren Jackson\jacksja01,SG,34,ORL,9,0,144,15,37,0.405,7,20,0.35,8,17,0.471,0.5,2,4,0.5,1,16,17,8,5,0,8,13,39
2001-2002,Jermaine Jackson\jacksje01,SG,25,TOR,24,0,280,20,42,0.476,1,2,0.5,19,40,0.475,0.488,16,24,0.667,3,24,27,57,9,1,14,24,57
2001-2002,Jim Jackson\jacksji01,SF,31,MIA,55,19,1825,238,538,0.442,38,81,0.469,200,457,0.438,0.478,75,87,0.862,54,236,290,140,42,14,106,145,589
2001-2002,Marc Jackson\jacksma02,C,27,TOT,39,0,495,60,164,0.366,0,1,0,60,163,0.368,0.366,66,80,0.825,48,80,128,14,11,6,30,69,186
2001-2002,Marc Jackson\jacksma02,C,27,GSW,17,0,169,22,65,0.338,0,0,,22,65,0.338,0.338,40,48,0.833,17,26,43,7,5,3,12,25,84
2001-2002,Marc Jackson\jacksma02,C,27,MIN,22,0,326,38,99,0.384,0,1,0,38,98,0.388,0.384,26,32,0.813,31,54,85,7,6,3,18,44,102
2001-2002,Mark Jackson\jacksma01,PG,36,NYK,82,82,2367,260,592,0.439,79,195,0.405,181,397,0.456,0.506,87,110,0.791,56,253,309,605,74,1,150,162,686
2001-2002,Stephen Jackson\jacksst02,SF,23,SAS,23,1,227,34,91,0.374,9,36,0.25,25,55,0.455,0.423,12,17,0.706,3,23,26,11,15,3,23,29,89
2001-2002,Jerome James\jamesje01,C,26,SEA,56,40,949,134,273,0.491,0,0,,134,273,0.491,0.491,30,60,0.5,89,143,232,24,25,86,74,174,298
2001-2002,Mike James\jamesmi01,PG,26,MIA,15,0,119,15,43,0.349,8,21,0.381,7,22,0.318,0.442,4,7,0.571,2,12,14,19,6,1,13,17,42
2001-2002,Tim James\jamesti01,SF,25,PHI,9,0,41,5,13,0.385,0,0,,5,13,0.385,0.385,2,6,0.333,5,2,7,1,0,1,3,5,12
2001-2002,Antawn Jamison\jamisan01,SF,25,GSW,82,82,3033,614,1375,0.447,68,210,0.324,546,1165,0.469,0.471,323,440,0.734,211,345,556,161,70,45,161,187,1619
2001-2002,Harold Jamison\jamisha01,PF,25,LAC,25,2,176,22,43,0.512,0,0,,22,43,0.512,0.512,10,15,0.667,24,15,39,6,5,1,6,23,54
2001-2002,Richard Jefferson\jefferi01,SF,21,NJN,79,9,1917,270,591,0.457,13,56,0.232,257,535,0.48,0.468,189,265,0.713,85,208,293,140,64,48,107,211,742
2001-2002,Anthony Johnson\johnsan02,SG,27,NJN,34,0,366,37,90,0.411,4,12,0.333,33,78,0.423,0.433,16,25,0.64,10,19,29,48,31,1,20,30,94
2001-2002,Avery Johnson\johnsav01,PG,36,TOT,68,13,1352,207,432,0.479,0,5,0,207,427,0.485,0.479,121,163,0.742,14,55,69,286,40,9,76,86,535
2001-2002,Avery Johnson\johnsav01,PG,36,DEN,51,13,1200,186,383,0.486,0,5,0,186,378,0.492,0.486,109,146,0.747,14,50,64,258,35,8,67,69,481
2001-2002,Avery Johnson\johnsav01,PG,36,DAL,17,0,152,21,49,0.429,0,0,,21,49,0.429,0.429,12,17,0.706,0,5,5,28,5,1,9,17,54
2001-2002,DerMarr Johnson\johnsde03,SF,21,ATL,72,46,1727,214,540,0.396,89,247,0.36,125,293,0.427,0.479,85,105,0.81,59,188,247,81,62,56,102,163,602
2001-2002,Ervin Johnson\johnser02,C,34,MIL,81,9,1660,89,193,0.461,0,1,0,89,192,0.464,0.461,30,66,0.455,142,324,466,27,37,82,52,219,208
2001-2002,Joe Johnson\johnsjo02,SG,20,TOT,77,60,1916,251,584,0.43,38,130,0.292,213,454,0.469,0.462,41,53,0.774,75,182,257,179,59,20,71,114,581
2001-2002,Joe Johnson\johnsjo02,SG,20,BOS,48,33,1003,130,296,0.439,24,88,0.273,106,208,0.51,0.48,20,26,0.769,40,99,139,74,33,9,28,59,304
2001-2002,Joe Johnson\johnsjo02,SG,20,PHO,29,27,913,121,288,0.42,14,42,0.333,107,246,0.435,0.444,21,27,0.778,35,83,118,105,26,11,43,55,277
2001-2002,Alvin Jones\jonesal01,C,23,PHI,23,2,126,8,20,0.4,0,0,,8,20,0.4,0.4,10,20,0.5,13,23,36,3,3,9,11,35,26
2001-2002,Damon Jones\jonesda01,PG,25,DET,67,0,1083,114,284,0.401,69,186,0.371,45,98,0.459,0.523,43,59,0.729,13,90,103,140,23,1,61,83,340
2001-2002,Eddie Jones\jonesed02,SG,30,MIA,81,81,3156,517,1198,0.432,149,382,0.39,368,816,0.451,0.494,297,355,0.837,61,317,378,262,117,77,148,258,1480
2001-2002,Jumaine Jones\jonesju01,PF,22,CLE,81,36,2142,287,640,0.448,52,168,0.31,235,472,0.498,0.489,45,68,0.662,125,365,490,116,75,46,79,184,671
2001-2002,Popeye Jones\jonespo01,PF,31,WAS,79,40,1920,222,508,0.437,4,11,0.364,218,497,0.439,0.441,106,130,0.815,233,345,578,127,50,19,88,209,554
2001-2002,Michael Jordan*\jordami01,SF,38,WAS,60,53,2093,551,1324,0.416,10,53,0.189,541,1271,0.426,0.42,263,333,0.79,50,289,339,310,85,26,162,119,1375
2001-2002,Shawn Kemp\kempsh01,PF,32,POR,75,5,1232,175,407,0.43,0,4,0,175,403,0.434,0.43,104,131,0.794,90,198,288,52,43,33,81,184,454
2001-2002,Steve Kerr\kerrst01,PG,36,POR,65,0,775,102,217,0.47,26,66,0.394,76,151,0.503,0.53,39,40,0.975,6,54,60,63,13,1,24,49,269
2001-2002,Jason Kidd\kiddja01,PG,28,NJN,82,82,3056,445,1138,0.391,117,364,0.321,328,774,0.424,0.442,201,247,0.814,130,465,595,808,175,20,286,136,1208
2001-2002,Andrei Kirilenko\kirilan01,SF,20,UTA,82,40,2151,285,633,0.45,25,100,0.25,260,533,0.488,0.47,285,371,0.768,149,253,402,94,116,159,108,156,880
2001-2002,Kerry Kittles\kittlke01,SG,27,NJN,82,82,2601,438,940,0.466,98,242,0.405,340,698,0.487,0.518,128,172,0.744,68,207,275,216,130,31,109,108,1102
2001-2002,Brevin Knight\knighbr01,PG,26,MEM,53,11,1151,141,334,0.422,2,8,0.25,139,326,0.426,0.425,87,115,0.757,11,98,109,302,79,7,111,135,371
2001-2002,Travis Knight\knightr01,C,27,NYK,49,0,429,41,113,0.363,0,0,,41,113,0.363,0.363,16,21,0.762,48,56,104,8,11,10,27,95,98
2001-2002,Toni Kukoc\kukocto01,SF,33,ATL,59,9,1494,211,504,0.419,53,171,0.31,158,333,0.474,0.471,109,153,0.712,43,175,218,210,48,17,113,91,584
2001-2002,Christian Laettner\laettch01,PF,32,WAS,57,48,1441,168,362,0.464,2,10,0.2,166,352,0.472,0.467,66,76,0.868,74,227,301,151,60,25,85,129,404
2001-2002,Raef LaFrentz\lafrera01,C,25,TOT,78,76,2455,421,920,0.458,104,268,0.388,317,652,0.486,0.514,105,151,0.695,176,403,579,89,55,213,94,281,1051
2001-2002,Raef LaFrentz\lafrera01,C,25,DEN,51,51,1668,307,659,0.466,75,173,0.434,232,486,0.477,0.523,70,105,0.667,117,262,379,60,31,153,60,173,759
2001-2002,Raef LaFrentz\lafrera01,C,25,DAL,27,25,787,114,261,0.437,29,95,0.305,85,166,0.512,0.492,35,46,0.761,59,141,200,29,24,60,34,108,292
2001-2002,Trajan Langdon\langdtr01,SG,25,CLE,44,0,477,70,176,0.398,27,74,0.365,43,102,0.422,0.474,42,46,0.913,13,42,55,60,13,5,40,49,209
2001-2002,Dan Langhi\langhda01,SF,24,HOU,34,8,434,49,125,0.392,1,4,0.25,48,121,0.397,0.396,8,11,0.727,22,45,67,14,8,5,9,25,107
2001-2002,Rusty LaRue\larueru01,PG,28,UTA,33,0,542,73,185,0.395,17,50,0.34,56,135,0.415,0.441,30,35,0.857,11,38,49,71,17,7,43,58,193
2001-2002,Voshon Lenard\lenarvo01,SG,28,DEN,71,19,1665,315,769,0.41,89,240,0.371,226,529,0.427,0.467,94,120,0.783,38,145,183,130,59,25,91,105,813
2001-2002,Quincy Lewis\lewisqu01,SG,24,UTA,36,19,490,64,143,0.448,3,18,0.167,61,125,0.488,0.458,13,20,0.65,10,33,43,36,23,9,32,89,144
2001-2002,Rashard Lewis\lewisra02,SF,22,SEA,71,70,2585,455,972,0.468,123,316,0.389,332,656,0.506,0.531,162,200,0.81,139,359,498,123,104,40,97,174,1195
2001-2002,Randy Livingston\livinra01,PG,26,SEA,13,0,176,15,54,0.278,1,8,0.125,14,46,0.304,0.287,10,11,0.909,9,16,25,26,9,2,2,11,41
2001-2002,Art Long\longar01,PF,29,SEA,63,27,989,120,244,0.492,0,0,,120,244,0.492,0.492,45,85,0.529,107,144,251,41,22,28,63,180,285
2001-2002,Grant Long\longgr01,PF,35,MEM,66,56,1868,164,385,0.426,3,17,0.176,161,368,0.438,0.43,86,123,0.699,31,200,231,136,63,12,103,123,417
2001-2002,Felipe Lopez\lopezfe01,SG,27,MIN,67,0,581,59,156,0.378,14,33,0.424,45,123,0.366,0.423,37,55,0.673,29,51,80,39,18,1,36,73,169
2001-2002,Tyronn Lue\luety01,PG,24,WAS,71,0,1458,222,520,0.427,63,141,0.447,159,379,0.42,0.488,48,63,0.762,14,108,122,246,49,0,96,120,555
2001-2002,George Lynch\lynchge01,SF,31,CHH,45,18,893,73,198,0.369,1,6,0.167,72,192,0.375,0.371,25,40,0.625,70,116,186,54,40,14,41,75,172
2001-2002,Todd MacCulloch\maccuto01,C,26,NJN,62,61,1502,247,465,0.531,0,0,,247,465,0.531,0.531,110,164,0.671,157,221,378,78,24,89,66,181,604
2001-2002,Sam Mack\macksa01,SF,31,MIA,12,1,159,14,49,0.286,7,28,0.25,7,21,0.333,0.357,5,7,0.714,2,12,14,4,5,1,7,17,40
2001-2002,Mark Madsen\madsema01,PF,26,LAL,59,5,650,66,146,0.452,0,2,0,66,144,0.458,0.452,35,54,0.648,89,73,162,44,16,13,22,104,167
2001-2002,Corey Maggette\maggeco01,SG,22,LAC,63,52,1615,235,530,0.443,46,139,0.331,189,391,0.483,0.487,201,251,0.801,54,177,231,112,41,19,116,155,717
2001-2002,Jamaal Magloire\magloja01,C,23,CHH,82,8,1549,228,414,0.551,0,1,0,228,413,0.552,0.551,243,333,0.73,153,308,461,31,27,86,118,201,699
2001-2002,Dan Majerle\majerda01,SG,36,PHO,65,1,1180,99,289,0.343,79,235,0.336,20,54,0.37,0.479,23,39,0.59,28,148,176,90,48,15,35,104,300
2001-2002,Karl Malone*\malonka01,PF,38,UTA,80,80,3040,635,1399,0.454,9,25,0.36,626,1374,0.456,0.457,509,639,0.797,142,544,686,341,152,59,263,229,1788
2001-2002,Danny Manning\mannida01,PF,35,DAL,41,10,552,71,149,0.477,1,7,0.143,70,142,0.493,0.48,22,33,0.667,25,83,108,30,21,21,25,80,165
2001-2002,Stephon Marbury\marbust01,PG,24,PHO,82,80,3187,625,1413,0.442,71,248,0.286,554,1165,0.476,0.467,353,452,0.781,75,191,266,666,77,13,284,186,1674
2001-2002,Shawn Marion\mariosh01,SF,23,PHO,81,81,3109,654,1395,0.469,48,122,0.393,606,1273,0.476,0.486,191,226,0.845,211,592,803,162,149,86,144,214,1547
2001-2002,Sean Marks\marksse01,C,26,MIA,21,6,319,38,88,0.432,0,0,,38,88,0.432,0.432,20,34,0.588,19,56,75,8,5,10,19,40,96
2001-2002,Donny Marshall\marshdo02,SF,29,NJN,20,0,118,8,29,0.276,2,4,0.5,6,25,0.24,0.31,12,18,0.667,8,13,21,5,3,0,2,14,30
2001-2002,Donyell Marshall\marshdo01,SF,28,UTA,58,42,1750,343,661,0.519,13,42,0.31,330,619,0.533,0.529,160,226,0.708,158,285,443,101,50,67,124,150,859
2001-2002,Darrick Martin\martida01,PG,30,DAL,3,0,22,0,10,0,0,2,0,0,8,0,0,1,2,0.5,0,1,1,3,2,0,1,4,1
2001-2002,Kenyon Martin\martike01,PF,24,NJN,73,73,2504,445,962,0.463,15,67,0.224,430,895,0.48,0.47,181,267,0.678,113,275,388,192,90,121,172,261,1086
2001-2002,Jamal Mashburn\mashbja01,SF,29,CHH,40,40,1601,303,744,0.407,41,112,0.366,262,632,0.415,0.435,211,241,0.876,31,211,242,171,45,6,110,80,858
2001-2002,Anthony Mason\masonan01,PF,35,MIL,82,82,3143,316,626,0.505,1,1,1,315,625,0.504,0.506,154,221,0.697,124,522,646,346,57,22,130,187,787
2001-2002,Desmond Mason\masonde01,SF,24,SEA,75,20,2420,357,769,0.464,16,59,0.271,341,710,0.48,0.475,201,237,0.848,92,259,351,104,67,27,104,170,931
2001-2002,Tony Massenburg\masseto01,PF,34,MEM,73,31,1247,159,349,0.456,1,1,1,158,348,0.454,0.457,84,117,0.718,100,224,324,26,30,31,65,174,403
2001-2002,Walter McCarty\mccarwa01,PF,27,BOS,56,0,718,80,180,0.444,39,99,0.394,41,81,0.506,0.553,13,19,0.684,32,96,128,41,18,7,22,83,212
2001-2002,Amal McCaskill\mccasam01,C,28,SAS,27,0,153,20,49,0.408,0,0,,20,49,0.408,0.408,12,26,0.462,16,20,36,4,6,10,14,23,52
2001-2002,George McCloud\mccloge01,SF,34,DEN,69,26,1830,206,576,0.358,60,222,0.27,146,354,0.412,0.41,132,163,0.81,67,184,251,204,58,19,144,175,604
2001-2002,Jelani McCoy\mccoyje01,C,24,LAL,21,0,104,12,21,0.571,0,0,,12,21,0.571,0.571,2,8,0.25,8,17,25,7,0,5,8,14,26
2001-2002,Antonio McDyess\mcdyean01,PF,27,DEN,10,10,236,43,75,0.573,0,0,,43,75,0.573,0.573,27,33,0.818,18,37,55,18,10,8,20,20,113
2001-2002,Tracy McGrady*\mcgratr01,SG,22,ORL,76,76,2912,715,1586,0.451,103,283,0.364,612,1303,0.47,0.483,415,555,0.748,150,447,597,400,119,73,189,139,1948
2001-2002,Jeff McInnis\mcinnje01,PG,27,LAC,81,80,3030,463,1121,0.413,75,234,0.321,388,887,0.437,0.446,183,219,0.836,45,168,213,500,63,6,147,202,1184
2001-2002,Derrick McKey\mckeyde01,SF,35,PHI,41,1,784,52,122,0.426,5,12,0.417,47,110,0.427,0.447,10,14,0.714,48,79,127,45,41,4,22,90,119
2001-2002,Aaron McKie\mckieaa01,SG,29,PHI,48,16,1471,220,490,0.449,51,128,0.398,169,362,0.467,0.501,96,122,0.787,26,166,192,179,56,14,93,74,587
2001-2002,Stanislav Medvedenko\medvest01,C,22,LAL,71,6,729,145,304,0.477,0,4,0,145,300,0.483,0.477,41,62,0.661,85,73,158,43,29,11,42,119,331
2001-2002,Ron Mercer\mercero01,SG,25,TOT,53,41,1716,311,784,0.397,18,62,0.29,293,722,0.406,0.408,95,119,0.798,50,128,178,128,32,13,88,108,735
2001-2002,Ron Mercer\mercero01,SG,25,CHI,40,40,1503,286,717,0.399,17,57,0.298,269,660,0.408,0.411,84,108,0.778,44,111,155,118,30,10,79,86,673
2001-2002,Ron Mercer\mercero01,SG,25,IND,13,1,213,25,67,0.373,1,5,0.2,24,62,0.387,0.381,11,11,1,6,17,23,10,2,3,9,22,62
2001-2002,Chris Mihm\mihmch01,C,22,CLE,74,60,1659,221,526,0.42,3,7,0.429,218,519,0.42,0.423,124,179,0.693,133,259,392,24,18,89,97,260,569
2001-2002,Darius Miles\milesda01,SF,20,LAC,82,6,2227,309,642,0.481,3,19,0.158,306,623,0.491,0.484,158,255,0.62,109,344,453,184,71,103,160,184,779
2001-2002,Andre Miller\millean02,PG,25,CLE,81,81,3023,474,1045,0.454,22,87,0.253,452,958,0.472,0.464,365,447,0.817,108,271,379,882,126,34,245,228,1335
2001-2002,Brad Miller\millebr01,C,25,TOT,76,75,2263,366,733,0.499,3,7,0.429,363,726,0.5,0.501,297,383,0.775,252,369,621,152,76,41,115,244,1032
2001-2002,Brad Miller\millebr01,C,25,CHI,48,47,1391,208,452,0.46,2,4,0.5,206,448,0.46,0.462,190,253,0.751,176,225,401,101,52,29,74,156,608
2001-2002,Brad Miller\millebr01,C,25,IND,28,28,872,158,281,0.562,1,3,0.333,157,278,0.565,0.564,107,130,0.823,76,144,220,51,24,12,41,88,424
2001-2002,Mike Miller\millemi01,SF,21,ORL,63,53,2123,351,802,0.438,116,303,0.383,235,499,0.471,0.51,138,181,0.762,49,224,273,198,47,23,108,145,956
2001-2002,Reggie Miller*\millere01,SG,36,IND,79,79,2889,414,913,0.453,180,443,0.406,234,470,0.498,0.552,296,325,0.911,23,196,219,253,88,10,120,143,1304
2001-2002,Chris Mills\millsch01,SF,32,GSW,66,0,1237,178,427,0.417,48,127,0.378,130,300,0.433,0.473,85,107,0.794,51,139,190,72,31,13,56,120,489
2001-2002,Sam Mitchell\mitchsa01,SF,38,MIN,74,10,726,98,227,0.432,10,35,0.286,88,192,0.458,0.454,38,49,0.776,18,64,82,45,12,4,26,79,244
2001-2002,Cuttino Mobley\moblecu01,SG,26,HOU,74,74,3116,595,1358,0.438,149,377,0.395,446,981,0.455,0.493,267,314,0.85,63,237,300,187,109,37,180,189,1606
2001-2002,Nazr Mohammed\mohamna01,C,24,ATL,82,73,2168,329,713,0.461,0,1,0,329,712,0.462,0.461,137,222,0.617,242,409,651,33,63,61,118,252,795
2001-2002,Jerome Moiso\moisoje01,C,23,CHH,15,0,76,8,20,0.4,0,0,,8,20,0.4,0.4,0,0,,4,21,25,4,3,2,8,12,16
2001-2002,Eric Montross\montrer01,C,30,TOR,49,24,655,53,132,0.402,0,1,0,53,131,0.405,0.402,10,31,0.323,36,104,140,16,12,23,25,92,116
2001-2002,Mikki Moore\mooremi01,C,26,DET,30,0,217,29,61,0.475,1,2,0.5,28,59,0.475,0.484,20,26,0.769,22,31,53,11,7,9,14,35,79
2001-2002,Terence Morris\morrite01,SF,23,HOU,68,12,1110,111,289,0.384,15,78,0.192,96,211,0.455,0.41,18,28,0.643,77,134,211,64,21,27,45,72,255
2001-2002,Hanno Mottola\mottoha01,C,25,ATL,82,14,1371,169,384,0.44,1,13,0.077,168,371,0.453,0.441,57,76,0.75,81,187,268,50,20,19,70,174,396
2001-2002,Alonzo Mourning*\mournal01,C,31,MIA,75,74,2455,447,866,0.516,1,3,0.333,446,863,0.517,0.517,283,431,0.657,182,450,632,87,27,186,182,258,1178
2001-2002,Troy Murphy\murphtr01,PF,21,GSW,82,4,1448,178,423,0.421,3,9,0.333,175,414,0.423,0.424,121,156,0.776,99,223,322,70,36,21,84,217,480
2001-2002,Lamond Murray\murrala01,SF,28,CLE,71,68,2312,430,986,0.436,101,238,0.424,329,748,0.44,0.487,215,263,0.817,81,291,372,157,70,43,141,148,1176
2001-2002,Tracy Murray\murratr01,SF,30,TOR,40,3,473,85,207,0.411,40,104,0.385,45,103,0.437,0.507,17,21,0.81,18,35,53,19,11,8,25,38,227
2001-2002,Dikembe Mutombo*\mutomdi01,C,35,PHI,80,80,2907,321,641,0.501,0,0,,321,641,0.501,0.501,278,364,0.764,254,609,863,83,29,190,156,242,920
2001-2002,Mamadou N'Diaye\ndiayma02,C,26,TOR,5,0,46,6,10,0.6,0,0,,6,10,0.6,0.6,8,10,0.8,6,5,11,0,0,2,1,6,20
2001-2002,Lee Nailon\nailole01,SF,26,CHH,79,41,1912,369,764,0.483,1,2,0.5,368,762,0.483,0.484,112,150,0.747,103,188,291,94,59,17,96,175,851
2001-2002,Eduardo Najera\najered01,PF,25,DAL,62,11,1357,150,300,0.5,0,2,0,150,298,0.503,0.5,100,148,0.676,149,193,342,38,56,30,40,156,400
2001-2002,Steve Nash\nashst01,PG,27,DAL,82,82,2837,525,1088,0.483,156,343,0.455,369,745,0.495,0.554,260,293,0.887,50,204,254,634,53,4,229,164,1466
2001-2002,Tyrone Nesby\nesbyty01,SF,26,WAS,70,9,1498,183,421,0.435,13,47,0.277,170,374,0.455,0.45,64,93,0.688,105,213,318,91,61,22,49,164,443
2001-2002,Rasho Nesterovic\nestera01,C,25,MIN,82,82,2218,324,657,0.493,0,1,0,324,656,0.494,0.493,39,71,0.549,200,334,534,75,45,109,94,262,687
2001-2002,Ira Newble\newblir01,SF,27,ATL,42,35,1273,131,263,0.498,1,7,0.143,130,256,0.508,0.5,75,88,0.852,80,142,222,45,38,20,49,117,338
2001-2002,Johnny Newman\newmajo01,SF,38,DAL,47,17,724,67,148,0.453,22,57,0.386,45,91,0.495,0.527,42,58,0.724,9,40,49,14,29,4,21,88,198
2001-2002,Moochie Norris\norrimo01,PG,28,HOU,82,26,2249,251,631,0.398,36,134,0.269,215,497,0.433,0.426,127,169,0.751,73,173,246,403,81,4,156,130,665
2001-2002,Dirk Nowitzki\nowitdi01,C,23,DAL,76,76,2891,600,1258,0.477,139,350,0.397,461,908,0.508,0.532,440,516,0.853,120,635,755,186,83,77,145,222,1779
2001-2002,Jermaine O'Neal\onealje01,PF,23,IND,72,72,2707,543,1133,0.479,1,14,0.071,542,1119,0.484,0.48,284,413,0.688,188,569,757,118,45,166,174,269,1371
2001-2002,Shaquille O'Neal*\onealsh01,C,29,LAL,67,66,2422,712,1229,0.579,0,1,0,712,1228,0.58,0.579,398,717,0.555,235,480,715,200,41,137,171,199,1822
2001-2002,Charles Oakley\oaklech01,PF,38,CHI,57,36,1383,97,263,0.369,1,6,0.167,96,257,0.374,0.371,21,28,0.75,72,271,343,114,49,11,87,175,216
2001-2002,Lamar Odom\odomla01,SF,22,LAC,29,25,999,151,360,0.419,16,84,0.19,135,276,0.489,0.442,61,93,0.656,31,145,176,171,23,36,97,91,379
2001-2002,Hakeem Olajuwon*\olajuha01,C,39,TOR,61,37,1378,194,418,0.464,0,2,0,194,416,0.466,0.464,47,84,0.56,98,268,366,66,74,90,98,147,435
2001-2002,Dean Oliver\olivede01,PG,23,GSW,20,0,139,17,46,0.37,2,13,0.154,15,33,0.455,0.391,6,9,0.667,0,8,8,21,3,0,11,16,42
2001-2002,Kevin Ollie\ollieke01,PG,29,TOT,81,17,1723,137,353,0.388,1,2,0.5,136,351,0.387,0.39,187,227,0.824,25,159,184,291,62,2,106,97,462
2001-2002,Kevin Ollie\ollieke01,PG,29,CHI,52,17,1146,97,253,0.383,1,2,0.5,96,251,0.382,0.385,109,130,0.838,18,110,128,193,36,1,80,64,304
2001-2002,Kevin Ollie\ollieke01,PG,29,IND,29,0,577,40,100,0.4,0,0,,40,100,0.4,0.4,78,97,0.804,7,49,56,98,26,1,26,33,158
2001-2002,Michael Olowokandi\olowomi01,C,26,LAC,80,79,2568,384,886,0.433,0,0,,384,886,0.433,0.433,117,188,0.622,164,547,711,90,55,145,175,217,885
2001-2002,Greg Ostertag\ostergr01,C,28,UTA,74,14,1107,91,201,0.453,0,0,,91,201,0.453,0.453,63,130,0.485,125,188,313,50,15,109,51,152,245
2001-2002,Bo Outlaw\outlabo01,PF,30,TOT,83,36,1928,166,299,0.555,1,2,0.5,165,297,0.556,0.557,43,102,0.422,147,217,364,127,70,92,96,205,376
2001-2002,Bo Outlaw\outlabo01,PF,30,ORL,10,0,160,13,21,0.619,0,0,,13,21,0.619,0.619,8,18,0.444,15,14,29,5,9,9,11,23,34
2001-2002,Bo Outlaw\outlabo01,PF,30,PHO,73,36,1768,153,278,0.55,1,2,0.5,152,276,0.551,0.552,35,84,0.417,132,203,335,122,61,83,85,182,342
2001-2002,Doug Overton\overtdo01,PG,32,LAC,18,0,130,14,44,0.318,7,27,0.259,7,17,0.412,0.398,4,7,0.571,1,11,12,13,3,1,12,10,39
2001-2002,Olumide Oyedeji\oyedeol01,C,20,SEA,36,1,221,22,41,0.537,0,0,,22,41,0.537,0.537,11,18,0.611,27,52,79,4,4,2,14,36,55
2001-2002,Robert Pack\packro01,PG,32,MIN,16,0,252,25,68,0.368,1,4,0.25,24,64,0.375,0.375,11,15,0.733,7,16,23,49,13,0,20,32,62
2001-2002,Scott Padgett\padgesc01,PF,25,UTA,75,1,1295,188,395,0.476,49,113,0.434,139,282,0.493,0.538,75,102,0.735,111,174,285,82,43,13,69,140,500
2001-2002,Milt Palacio\palacmi01,PG-SG,23,TOT,69,1,790,82,214,0.383,13,41,0.317,69,173,0.399,0.414,54,74,0.73,11,62,73,83,30,4,40,61,231
2001-2002,Milt Palacio\palacmi01,PG,23,BOS,41,0,518,52,135,0.385,12,34,0.353,40,101,0.396,0.43,36,51,0.706,8,42,50,54,21,3,24,38,152
2001-2002,Milt Palacio\palacmi01,SG,23,PHO,28,1,272,30,79,0.38,1,7,0.143,29,72,0.403,0.386,18,23,0.783,3,20,23,29,9,1,16,23,79
2001-2002,Tony Parker\parketo01,PG,19,SAS,77,72,2267,268,639,0.419,61,189,0.323,207,450,0.46,0.467,108,160,0.675,33,164,197,334,89,7,151,166,705
2001-2002,Cherokee Parks\parksch02,C,29,SAS,42,1,234,30,83,0.361,0,0,,30,83,0.361,0.361,3,8,0.375,24,34,58,10,7,8,14,34,63
2001-2002,Ruben Patterson\patteru01,SF,26,POR,75,13,1765,319,619,0.515,9,36,0.25,310,583,0.532,0.523,192,274,0.701,155,143,298,107,79,37,114,140,839
2001-2002,Gary Payton*\paytoga01,PG,33,SEA,82,82,3301,737,1578,0.467,74,236,0.314,663,1342,0.494,0.49,267,335,0.797,80,316,396,737,131,26,209,179,1815
2001-2002,Anthony Peeler\peelean01,SG,32,MIN,82,0,2060,288,684,0.421,111,283,0.392,177,401,0.441,0.502,50,58,0.862,37,169,206,177,61,11,76,137,737
2001-2002,Mike Penberthy\penbemi01,PG,27,LAL,3,0,12,1,2,0.5,0,0,,1,2,0.5,0.5,3,4,0.75,0,2,2,2,2,0,0,0,5
2001-2002,Elliot Perry\perryel01,PG,32,MEM,2,0,48,5,10,0.5,0,0,,5,10,0.5,0.5,1,2,0.5,0,4,4,7,3,0,7,6,11
2001-2002,Wesley Person\persowe01,SG,30,CLE,78,78,2793,467,944,0.495,143,322,0.444,324,622,0.521,0.57,99,124,0.798,50,244,294,173,77,37,74,93,1176
2001-2002,Morris Peterson\petermo01,SF,24,TOR,63,56,1988,336,768,0.438,84,231,0.364,252,537,0.469,0.492,127,169,0.751,91,132,223,153,73,11,86,174,883
2001-2002,Eric Piatkowski\piatker01,SG,31,LAC,71,64,1718,207,471,0.439,111,238,0.466,96,233,0.412,0.557,101,113,0.894,43,141,184,112,41,12,64,110,626
2001-2002,Paul Pierce\piercpa01,SG,24,BOS,82,82,3302,707,1598,0.442,210,520,0.404,497,1078,0.461,0.508,520,643,0.809,81,485,566,261,154,86,241,237,2144
2001-2002,Scottie Pippen*\pippesc01,SF,36,POR,62,60,1996,246,599,0.411,54,177,0.305,192,422,0.455,0.456,113,146,0.774,77,244,321,363,101,35,171,162,659
2001-2002,Scot Pollard\pollasc01,C,26,SAC,80,29,1881,197,358,0.55,0,0,,197,358,0.55,0.55,115,166,0.693,188,377,565,53,70,76,68,202,509
2001-2002,Mark Pope\popema01,PF,29,MIL,45,12,426,36,91,0.396,4,25,0.16,32,66,0.485,0.418,11,21,0.524,20,53,73,17,11,11,15,47,87
2001-2002,Terry Porter\portete01,PG,38,SAS,72,0,1294,136,321,0.424,59,142,0.415,77,179,0.43,0.516,68,83,0.819,12,152,164,205,45,16,85,89,399
2001-2002,James Posey\poseyja01,SF,25,DEN,73,63,2238,277,736,0.376,67,237,0.283,210,499,0.421,0.422,161,203,0.793,109,320,429,180,114,39,127,224,782
2001-2002,Lavor Postell\postela01,SG,23,NYK,23,0,179,28,84,0.333,6,26,0.231,22,58,0.379,0.369,31,41,0.756,2,14,16,5,6,0,11,7,93
2001-2002,Vitaly Potapenko\potapvi01,C,26,BOS,79,9,1343,137,301,0.455,0,0,,137,301,0.455,0.455,89,120,0.742,167,180,347,30,37,18,63,174,363
2001-2002,Brent Price\pricebr01,PG,33,SAC,20,0,89,9,27,0.333,4,15,0.267,5,12,0.417,0.407,9,13,0.692,4,4,8,9,3,1,10,13,31
2001-2002,Joel Przybilla\przybjo01,C,22,MIL,71,62,1128,76,142,0.535,0,1,0,76,141,0.539,0.535,38,90,0.422,78,205,283,21,20,118,43,199,190
2001-2002,Vladimir Radmanovic\radmavl01,PF,21,SEA,61,16,1230,146,354,0.412,66,157,0.42,80,197,0.406,0.506,49,72,0.681,45,185,230,81,56,24,72,119,407
2001-2002,Zach Randolph\randoza01,PF,20,POR,41,0,238,48,107,0.449,0,0,,48,107,0.449,0.449,18,27,0.667,31,38,69,13,7,4,15,29,114
2001-2002,Theo Ratliff\ratlith01,C,28,ATL,3,2,82,10,20,0.5,0,0,,10,20,0.5,0.5,6,11,0.545,5,11,16,1,1,8,7,8,26
2001-2002,Zeljko Rebraca\rebraze01,C,29,DET,74,4,1179,189,374,0.505,0,0,,189,374,0.505,0.505,135,175,0.771,84,206,290,38,28,73,84,192,513
2001-2002,Eldridge Recasner\recasel01,PG-SG,34,TOT,6,0,33,2,6,0.333,0,1,0,2,5,0.4,0.333,1,1,1,0,0,0,5,1,0,1,4,5
2001-2002,Eldridge Recasner\recasel01,SG,34,CHH,1,0,2,0,0,,0,0,,0,0,,,0,0,,0,0,0,0,0,0,0,1,0
2001-2002,Eldridge Recasner\recasel01,PG,34,LAC,5,0,31,2,6,0.333,0,1,0,2,5,0.4,0.333,1,1,1,0,0,0,5,1,0,1,3,5
2001-2002,Michael Redd\reddmi01,SG,22,MIL,67,8,1417,294,609,0.483,88,198,0.444,206,411,0.501,0.555,91,115,0.791,77,147,224,91,42,7,57,96,767
2001-2002,Don Reid\reiddo01,PF,28,ORL,68,5,714,90,190,0.474,0,0,,90,190,0.474,0.474,44,68,0.647,65,111,176,27,20,44,54,180,224
2001-2002,Glen Rice\ricegl01,SF,34,HOU,20,20,606,65,167,0.389,18,64,0.281,47,103,0.456,0.443,24,30,0.8,5,42,47,31,12,3,24,34,172
2001-2002,Jason Richardson\richaja01,SG,21,GSW,80,75,2629,464,1090,0.426,82,246,0.333,382,844,0.453,0.463,141,210,0.671,124,216,340,236,106,31,160,195,1151
2001-2002,Norm Richardson\richano01,SG,22,TOT,11,0,67,10,26,0.385,4,8,0.5,6,18,0.333,0.462,6,9,0.667,3,5,8,2,0,0,3,5,30
2001-2002,Norm Richardson\richano01,SG,22,IND,3,0,4,0,3,0,0,0,,0,3,0,0,0,0,,1,0,1,1,0,0,0,0,0
2001-2002,Norm Richardson\richano01,SG,22,CHI,8,0,63,10,23,0.435,4,8,0.5,6,15,0.4,0.522,6,9,0.667,2,5,7,1,0,0,3,5,30
2001-2002,Quentin Richardson\richaqu01,SG,21,LAC,81,0,2152,400,926,0.432,133,349,0.381,267,577,0.463,0.504,143,187,0.765,113,221,334,128,78,21,102,142,1076
2001-2002,Mitch Richmond*\richmmi01,SG,36,LAL,64,2,709,100,247,0.405,18,62,0.29,82,185,0.443,0.441,42,44,0.955,14,80,94,57,18,6,40,61,260
2001-2002,Isaiah Rider\rideris01,SG,30,DEN,10,1,173,37,81,0.457,6,15,0.4,31,66,0.47,0.494,13,17,0.765,10,23,33,12,3,2,14,11,93
2001-2002,Clifford Robinson\robincl02,PF,35,DET,80,80,2855,454,1069,0.425,115,304,0.378,339,765,0.443,0.478,143,206,0.694,79,307,386,202,89,95,151,243,1166
2001-2002,David Robinson*\robinda01,C,36,SAS,78,78,2303,341,672,0.507,0,0,,341,672,0.507,0.507,269,395,0.681,191,456,647,94,86,140,104,193,951
2001-2002,Eddie Robinson\robined01,SF,25,CHI,29,12,653,112,247,0.453,2,5,0.4,110,242,0.455,0.457,36,48,0.75,24,54,78,37,23,11,36,35,262
2001-2002,Glenn Robinson\robingl01,SF,29,MIL,66,63,2346,536,1147,0.467,58,178,0.326,478,969,0.493,0.493,236,282,0.837,70,336,406,168,97,41,174,173,1366
2001-2002,Larry Robinson\robinla01,SG,34,NYK,2,0,10,1,4,0.25,1,2,0.5,0,2,0,0.375,0,0,,0,2,2,0,0,0,0,1,3
2001-2002,Carlos Rogers\rogerca01,C,30,IND,22,1,168,24,43,0.558,1,6,0.167,23,37,0.622,0.57,10,19,0.526,14,24,38,3,5,6,5,17,59
2001-2002,Rodney Rogers\rogerro01,SF,30,TOT,77,8,1880,356,756,0.471,88,235,0.374,268,521,0.514,0.529,117,149,0.785,129,219,348,112,66,29,108,226,917
2001-2002,Rodney Rogers\rogerro01,SF,30,PHO,50,7,1254,249,534,0.466,49,140,0.35,200,394,0.508,0.512,82,99,0.828,95,146,241,72,50,17,66,148,629
2001-2002,Rodney Rogers\rogerro01,SF,30,BOS,27,1,626,107,222,0.482,39,95,0.411,68,127,0.535,0.57,35,50,0.7,34,73,107,40,16,12,42,78,288
2001-2002,Sean Rooks\rooksse01,C,32,LAC,61,2,728,81,194,0.418,0,0,,81,194,0.418,0.418,21,29,0.724,32,92,124,25,12,21,20,114,183
2001-2002,Jalen Rose\roseja01,SF,29,TOT,83,83,3153,663,1458,0.455,89,246,0.362,574,1212,0.474,0.485,281,335,0.839,43,330,373,355,78,45,201,251,1696
2001-2002,Jalen Rose\roseja01,SF,29,IND,53,53,1937,387,871,0.444,52,146,0.356,335,725,0.462,0.474,156,186,0.839,29,220,249,197,45,29,105,148,982
2001-2002,Jalen Rose\roseja01,SF,29,CHI,30,30,1216,276,587,0.47,37,100,0.37,239,487,0.491,0.502,125,149,0.839,14,110,124,158,33,16,96,103,714
2001-2002,Malik Rose\rosema01,PF,27,SAS,82,1,1725,293,633,0.463,1,12,0.083,292,621,0.47,0.464,185,257,0.72,172,320,492,61,70,42,140,208,772
2001-2002,Michael Ruffin\ruffimi01,PF,25,PHI,15,0,169,7,26,0.269,0,0,,7,26,0.269,0.269,2,8,0.25,23,28,51,5,5,8,11,23,16
2001-2002,Bryon Russell\russebr01,SG,31,UTA,66,40,1998,222,584,0.38,77,226,0.341,145,358,0.405,0.446,115,140,0.821,79,216,295,136,64,19,110,205,636
2001-2002,Daniel Santiago\santida01,C,25,PHO,3,0,24,4,8,0.5,0,0,,4,8,0.5,0.5,0,0,,0,7,7,2,0,1,2,4,8
2001-2002,Jeryl Sasser\sasseje01,SG,22,ORL,7,0,36,3,14,0.214,0,0,,3,14,0.214,0.214,4,5,0.8,3,4,7,2,3,0,2,3,10
2001-2002,Kenny Satterfield\satteke01,PG,20,DEN,36,4,560,73,199,0.367,7,27,0.259,66,172,0.384,0.384,36,46,0.783,17,35,52,108,31,1,53,43,189
2001-2002,Brian Scalabrine\scalabr01,PF,23,NJN,28,0,290,23,67,0.343,3,10,0.3,20,57,0.351,0.366,11,15,0.733,12,39,51,21,9,2,24,39,60
2001-2002,Shawnelle Scott\scottsh01,C,29,DEN,21,10,252,37,75,0.493,0,0,,37,75,0.493,0.493,8,20,0.4,53,50,103,8,3,6,15,49,82
2001-2002,Ansu Sesay\sesayan01,SF,25,SEA,9,0,142,22,44,0.5,0,0,,22,44,0.5,0.5,14,20,0.7,7,13,20,8,3,2,2,18,58
2001-2002,Brian Shaw\shawbr01,PG,35,LAL,58,0,631,61,173,0.353,29,88,0.33,32,85,0.376,0.436,18,26,0.692,19,93,112,89,25,3,32,43,169
2001-2002,Bobby Simmons\simmobo01,SF,21,WAS,30,3,343,43,95,0.453,4,14,0.286,39,81,0.481,0.474,22,30,0.733,25,27,52,17,13,5,14,31,112
2001-2002,Dickey Simpkins\simpkdi01,PF,29,ATL,1,0,3,0,0,,0,0,,0,0,,,0,0,,0,0,0,1,0,0,0,0,0
2001-2002,Brian Skinner\skinnbr01,PF,25,CLE,65,8,1107,88,162,0.543,0,0,,88,162,0.543,0.543,48,79,0.608,93,188,281,17,24,61,42,130,224
2001-2002,Reggie Slater\slatere01,PF,31,TOT,8,0,47,7,15,0.467,0,0,,7,15,0.467,0.467,7,10,0.7,5,4,9,1,1,1,1,3,21
2001-2002,Reggie Slater\slatere01,PF,31,NJN,4,0,10,2,2,1,0,0,,2,2,1,1,1,1,1,0,2,2,0,0,0,1,1,5
2001-2002,Reggie Slater\slatere01,PF,31,ATL,4,0,37,5,13,0.385,0,0,,5,13,0.385,0.385,6,9,0.667,5,2,7,1,1,1,0,2,16
2001-2002,Charles Smith\smithch04,SG,26,SAS,60,22,1141,182,428,0.425,35,131,0.267,147,297,0.495,0.466,42,65,0.646,34,99,133,80,52,44,59,114,441
2001-2002,Jabari Smith\smithja01,C,24,TOT,23,0,181,26,63,0.413,0,3,0,26,60,0.433,0.413,21,32,0.656,8,20,28,11,6,6,5,31,73
2001-2002,Jabari Smith\smithja01,C,24,SAC,12,0,71,6,21,0.286,0,1,0,6,20,0.3,0.286,6,12,0.5,2,12,14,6,2,4,2,12,18
2001-2002,Jabari Smith\smithja01,C,24,PHI,11,0,110,20,42,0.476,0,2,0,20,40,0.5,0.476,15,20,0.75,6,8,14,5,4,2,3,19,55
2001-2002,Joe Smith\smithjo02,C,26,MIN,72,63,1922,297,581,0.511,2,3,0.667,295,578,0.51,0.513,171,206,0.83,152,301,453,82,39,59,86,250,767
2001-2002,Leon Smith\smithle01,C,21,ATL,14,0,100,10,26,0.385,0,0,,10,26,0.385,0.385,11,17,0.647,10,21,31,3,5,1,3,12,31
2001-2002,Steve Smith\smithst01,SG,32,SAS,77,76,2211,310,682,0.455,116,246,0.472,194,436,0.445,0.54,159,181,0.878,45,148,193,151,54,15,108,158,895
2001-2002,Eric Snow\snower01,PG,28,PHI,61,61,2225,276,624,0.442,3,27,0.111,273,597,0.457,0.445,183,227,0.806,33,182,215,400,95,9,138,167,738
2001-2002,Will Solomon\solomwi01,SG,23,MEM,62,4,872,113,331,0.341,46,162,0.284,67,169,0.396,0.411,49,73,0.671,12,56,68,92,35,7,62,76,321
2001-2002,Felton Spencer\spencfe01,C,34,NYK,32,8,248,6,26,0.231,0,0,,6,26,0.231,0.231,17,33,0.515,16,34,50,3,7,8,12,73,29
2001-2002,Latrell Sprewell\sprewla01,SF,31,NYK,81,81,3326,573,1419,0.404,145,403,0.36,428,1016,0.421,0.455,284,346,0.821,59,239,298,313,94,14,223,161,1575
2001-2002,Jerry Stackhouse\stackje01,SF,27,DET,76,76,2685,524,1319,0.397,86,300,0.287,438,1019,0.43,0.43,495,577,0.858,77,238,315,403,77,37,266,163,1629
2001-2002,John Starks\starkjo01,SG,36,UTA,66,1,929,114,310,0.368,29,95,0.305,85,215,0.395,0.415,33,41,0.805,15,53,68,70,33,0,52,126,290
2001-2002,Vladimir Stepania\stepavl01,C,25,MIA,67,4,884,117,249,0.47,1,2,0.5,116,247,0.47,0.472,50,104,0.481,100,170,270,16,24,44,52,103,285
2001-2002,DeShawn Stevenson\stevede01,SG,20,UTA,67,23,1134,143,371,0.385,2,25,0.08,141,346,0.408,0.388,37,53,0.698,44,87,131,116,29,24,68,82,325
2001-2002,Michael Stewart\stewami01,C,26,TOR,11,0,93,8,23,0.348,0,0,,8,23,0.348,0.348,6,11,0.545,12,13,25,3,4,3,4,22,22
2001-2002,Bryant Stith\stithbr01,SG,31,CLE,50,5,665,70,188,0.372,24,68,0.353,46,120,0.383,0.436,44,52,0.846,20,65,85,42,29,6,30,42,208
2001-2002,John Stockton*\stockjo01,PG,39,UTA,82,82,2566,401,775,0.517,25,78,0.321,376,697,0.539,0.534,275,321,0.857,59,204,263,674,152,24,208,209,1102
2001-2002,Peja Stojakovic\stojape01,SF,24,SAC,71,71,2649,547,1130,0.484,129,310,0.416,418,820,0.51,0.541,283,323,0.876,72,301,373,175,81,14,140,120,1506
2001-2002,Damon Stoudamire\stoudda01,PG,28,POR,75,71,2796,369,918,0.402,104,295,0.353,265,623,0.425,0.459,174,196,0.888,78,214,292,490,67,7,149,153,1016
2001-2002,Erick Strickland\stricer01,PG,28,BOS,79,4,1643,190,488,0.389,95,247,0.385,95,241,0.394,0.487,131,155,0.845,22,191,213,184,56,1,94,145,606
2001-2002,Mark Strickland\stricma01,SF,31,ATL,46,10,654,91,204,0.446,1,4,0.25,90,200,0.45,0.449,25,44,0.568,41,90,131,20,19,17,28,48,208
2001-2002,Rod Strickland\stricro02,PG,35,MIA,76,64,2294,316,714,0.443,8,26,0.308,308,688,0.448,0.448,154,201,0.766,49,183,232,463,82,11,159,114,794
2001-2002,Bruno Sundov\sundobr01,C,21,IND,22,0,88,16,40,0.4,0,1,0,16,39,0.41,0.4,0,2,0,7,14,21,3,3,3,4,16,32
2001-2002,Bob Sura\surabo01,PG,28,GSW,78,5,1780,250,590,0.424,42,133,0.316,208,457,0.455,0.459,236,328,0.72,89,167,256,275,88,17,133,160,778
2001-2002,Stromile Swift\swiftst01,PF,22,MEM,68,14,1805,293,611,0.48,0,3,0,293,608,0.482,0.48,217,305,0.711,161,269,430,50,53,113,122,178,803
2001-2002,Wally Szczerbiak\szczewa02,SF,24,MIN,82,82,3117,609,1200,0.508,87,191,0.455,522,1009,0.517,0.544,226,272,0.831,120,271,391,257,66,21,181,188,1531
2001-2002,Jason Terry\terryja01,SG,24,ATL,78,78,2967,524,1219,0.43,172,444,0.387,352,775,0.454,0.5,284,340,0.835,40,230,270,444,144,13,181,156,1504
2001-2002,Etan Thomas\thomaet01,C,23,WAS,47,0,618,81,151,0.536,0,0,,81,151,0.536,0.536,41,74,0.554,55,126,181,6,17,35,26,76,203
2001-2002,Kenny Thomas\thomake01,PF,24,HOU,72,71,2484,396,829,0.478,0,16,0,396,813,0.487,0.478,223,336,0.664,158,358,516,137,85,66,143,195,1015
2001-2002,Kurt Thomas\thomaku01,C,29,NYK,82,82,2771,463,938,0.494,1,6,0.167,462,932,0.496,0.494,216,265,0.815,214,533,747,87,71,79,153,341,1143
2001-2002,Tim Thomas\thomati01,SF,24,MIL,74,22,1987,316,753,0.42,95,291,0.326,221,462,0.478,0.483,142,179,0.793,64,236,300,105,65,32,127,200,869
2001-2002,Jamaal Tinsley\tinslja01,PG,23,IND,80,78,2442,289,760,0.38,42,175,0.24,247,585,0.422,0.408,131,186,0.704,78,220,298,647,138,40,270,248,751
2001-2002,Oscar Torres\torreos01,SG,25,HOU,65,13,1075,135,341,0.396,37,126,0.294,98,215,0.456,0.45,82,105,0.781,47,75,122,40,25,9,49,64,389
2001-2002,Robert Traylor\traylro01,PF,24,CHH,61,1,678,87,204,0.426,1,1,1,86,203,0.424,0.429,53,84,0.631,67,120,187,37,24,37,45,127,228
2001-2002,Gary Trent\trentga01,PF,27,MIN,64,10,1140,193,381,0.507,0,2,0,193,379,0.509,0.507,92,144,0.639,104,166,270,60,21,27,58,160,478
2001-2002,Jeff Trepagnier\trepaje01,SG,22,CLE,12,0,77,7,23,0.304,0,1,0,7,22,0.318,0.304,4,7,0.571,3,9,12,12,8,4,11,8,18
2001-2002,Jake Tsakalidis\tsakaja01,C,22,PHO,67,47,1582,190,400,0.475,0,1,0,190,399,0.476,0.475,111,159,0.698,130,244,374,23,23,69,78,193,491
2001-2002,Hedo Turkoglu\turkohe01,SF,22,SAC,80,10,1970,290,687,0.422,63,171,0.368,227,516,0.44,0.468,167,230,0.726,63,300,363,163,57,31,81,184,810
2001-2002,Nick Van Exel\vanexni01,PG-SG,30,TOT,72,46,2496,501,1226,0.409,119,350,0.34,382,876,0.436,0.457,201,251,0.801,28,226,254,478,44,11,156,104,1322
2001-2002,Nick Van Exel\vanexni01,PG,30,DEN,45,44,1739,372,912,0.408,85,252,0.337,287,660,0.435,0.454,136,174,0.782,19,150,169,365,30,7,116,69,965
2001-2002,Nick Van Exel\vanexni01,SG,30,DAL,27,2,757,129,314,0.411,34,98,0.347,95,216,0.44,0.465,65,77,0.844,9,76,85,113,14,4,40,35,357
2001-2002,Keith Van Horn\vanhoke01,SF,26,NJN,81,81,2465,471,1089,0.433,101,293,0.345,370,796,0.465,0.479,156,195,0.8,137,472,609,164,63,42,146,221,1199
2001-2002,Ratko Varda\vardara01,C,22,DET,1,0,6,2,3,0.667,0,0,,2,3,0.667,0.667,1,1,1,0,1,1,0,0,0,1,3,5
2001-2002,Jacque Vaughn\vaughja01,PG,26,ATL,82,16,1856,206,438,0.47,24,54,0.444,182,384,0.474,0.498,104,126,0.825,18,150,168,349,65,2,112,183,540
2001-2002,Jake Voskuhl\voskuja01,C,24,PHO,59,34,900,107,193,0.554,0,0,,107,193,0.554,0.554,82,109,0.752,103,147,250,18,11,23,48,139,296
2001-2002,Antoine Walker\walkean02,PF,25,BOS,81,81,3406,666,1689,0.394,222,645,0.344,444,1044,0.425,0.46,240,324,0.741,150,564,714,407,122,38,251,237,1794
2001-2002,Samaki Walker\walkesa01,PF,25,LAL,69,63,1655,187,365,0.512,0,0,,187,365,0.512,0.512,86,129,0.667,129,352,481,64,28,88,53,170,460
2001-2002,Ben Wallace\wallabe01,C,27,DET,80,80,2921,255,480,0.531,0,3,0,255,477,0.535,0.531,99,234,0.423,318,721,1039,115,138,278,70,178,609
2001-2002,Gerald Wallace\wallage01,SF,19,SAC,54,1,430,75,175,0.429,0,7,0,75,168,0.446,0.429,23,46,0.5,49,40,89,27,19,6,22,46,173
2001-2002,John Wallace\wallajo01,SF,27,PHO,46,0,490,93,214,0.435,5,13,0.385,88,201,0.438,0.446,40,46,0.87,27,58,85,29,11,9,29,60,231
2001-2002,Rasheed Wallace\wallara01,PF,27,POR,79,79,2963,603,1287,0.469,114,317,0.36,489,970,0.504,0.513,201,274,0.734,136,509,645,152,101,101,131,212,1521
2001-2002,Charlie Ward\wardch01,PG,31,NYK,63,0,1058,113,303,0.373,53,164,0.323,60,139,0.432,0.46,47,58,0.81,15,112,127,203,68,14,75,100,326
2001-2002,Earl Watson\watsoea01,PG,22,SEA,64,0,964,96,212,0.453,16,44,0.364,80,168,0.476,0.491,23,36,0.639,31,52,83,125,60,5,51,93,231
2001-2002,Clarence Weatherspoon\weathcl01,PF,31,NYK,56,41,1728,189,452,0.418,0,0,,189,452,0.418,0.418,116,146,0.795,149,311,460,60,37,48,47,132,494
2001-2002,Chris Webber\webbech01,PF,28,SAC,54,54,2071,532,1075,0.495,5,19,0.263,527,1056,0.499,0.497,253,338,0.749,150,396,546,258,90,76,158,181,1322
2001-2002,Bonzi Wells\wellsbo01,SG,25,POR,74,69,2348,487,1039,0.469,66,172,0.384,421,867,0.486,0.5,215,290,0.741,121,323,444,204,113,25,191,208,1255
2001-2002,David Wesley\wesleda01,SG,31,CHH,67,63,2487,364,910,0.4,85,256,0.332,279,654,0.427,0.447,138,188,0.734,44,99,143,236,74,15,119,147,951
2001-2002,Jahidi White\whiteja01,C,25,WAS,71,69,1346,150,279,0.538,0,0,,150,279,0.538,0.538,83,154,0.539,159,285,444,17,25,75,65,163,383
2001-2002,Rodney White\whitero02,SF,21,DET,16,0,129,21,60,0.35,2,9,0.222,19,51,0.373,0.367,12,14,0.857,2,16,18,12,9,2,14,6,56
2001-2002,Chris Whitney\whitnch01,PG,30,WAS,82,81,2171,274,656,0.418,131,323,0.406,143,333,0.429,0.518,154,175,0.88,11,141,152,314,72,6,85,182,833
2001-2002,Aaron Williams\williaa01,PF,30,NJN,82,13,1546,231,439,0.526,0,2,0,231,437,0.529,0.526,130,186,0.699,115,224,339,77,29,76,79,212,592
2001-2002,Alvin Williams\willial02,PG,27,TOR,82,82,2927,403,971,0.415,62,193,0.321,341,778,0.438,0.447,103,140,0.736,58,223,281,468,135,26,150,191,971
2001-2002,Eric Williams\willier01,SF,29,BOS,74,30,1747,144,385,0.374,24,86,0.279,120,299,0.401,0.405,160,219,0.731,58,163,221,109,77,8,95,179,472
2001-2002,Jason Williams\willija02,PG,26,MEM,65,65,2236,376,985,0.382,127,430,0.295,249,555,0.449,0.446,80,101,0.792,22,173,195,519,111,7,214,102,959
2001-2002,Jerome Williams\willije01,PF,28,TOR,68,32,1641,190,388,0.49,0,0,,190,388,0.49,0.49,138,204,0.676,165,221,386,75,78,25,68,153,518
2001-2002,Monty Williams\willimo01,SF,30,ORL,68,19,1284,198,362,0.547,0,4,0,198,358,0.553,0.547,88,134,0.657,80,155,235,96,49,17,86,134,484
2001-2002,Scott Williams\willisc01,PF,33,DEN,41,16,737,86,217,0.396,0,2,0,86,215,0.4,0.396,30,41,0.732,82,127,209,13,17,33,35,98,202
2001-2002,Shammond Williams\willish01,SG,26,SEA,50,2,603,81,193,0.42,28,75,0.373,53,118,0.449,0.492,31,39,0.795,16,47,63,83,21,2,35,35,221
2001-2002,Walt Williams\williwa02,SF,31,HOU,48,25,1117,166,396,0.419,78,183,0.426,88,213,0.413,0.518,40,51,0.784,37,125,162,69,18,10,53,106,450
2001-2002,Corliss Williamson\willico02,SF,28,DET,78,7,1701,411,806,0.51,1,5,0.2,410,801,0.512,0.511,240,298,0.805,117,202,319,94,49,26,137,226,1063
2001-2002,Kevin Willis\willike02,PF,39,HOU,52,5,865,125,284,0.44,0,1,0,125,283,0.442,0.44,65,87,0.747,105,194,299,14,25,23,41,98,315
2001-2002,Loren Woods\woodslo01,C,23,MIN,60,0,516,33,96,0.344,0,2,0,33,94,0.351,0.344,44,60,0.733,46,76,122,22,17,34,36,60,110
2001-2002,Metta World Peace\artesro01,SF,22,TOT,55,50,1642,269,636,0.423,53,170,0.312,216,466,0.464,0.465,136,204,0.667,73,198,271,127,141,39,118,217,727
2001-2002,Metta World Peace\artesro01,SF,22,CHI,27,26,823,152,351,0.433,36,91,0.396,116,260,0.446,0.484,81,129,0.628,40,91,131,77,75,23,69,108,421
2001-2002,Metta World Peace\artesro01,SF,22,IND,28,24,819,117,285,0.411,17,79,0.215,100,206,0.485,0.44,55,75,0.733,33,107,140,50,66,16,49,109,306
2001-2002,Lorenzen Wright\wrighlo02,C,26,MEM,43,33,1251,223,486,0.459,0,2,0,223,484,0.461,0.459,70,123,0.569,130,275,405,44,30,23,72,126,516
2001-2002,Wang Zhizhi\zhizhwa01,C,24,DAL,55,0,600,109,248,0.44,48,116,0.414,61,132,0.462,0.536,42,57,0.737,19,92,111,22,11,18,25,84,308Season,Player,Pos,Age,Tm,G,GS,MP,FG,FGA,FG%,3P,3PA,3P%,2P,2PA,2P%,eFG%,FT,FTA,FT%,ORB,DRB,TRB,AST,STL,BLK,TOV,PF,PTS
2002-2003,Tariq Abdul-Wahad\abdulta01,SG,28,DAL,14,0,204,27,58,0.466,0,1,0,27,57,0.474,0.466,3,6,0.5,14,26,40,21,6,3,7,26,57
2002-2003,Shareef Abdur-Rahim\abdursh01,PF,26,ATL,81,81,3087,566,1183,0.478,21,60,0.35,545,1123,0.485,0.487,455,541,0.841,175,502,677,242,87,38,212,240,1608
2002-2003,Courtney Alexander\alexaco02,PG,25,NOH,66,7,1360,193,505,0.382,19,57,0.333,174,448,0.388,0.401,118,146,0.808,39,79,118,79,31,6,68,125,523
2002-2003,Malik Allen\allenma01,PF,24,MIA,80,73,2318,335,790,0.424,0,4,0,335,786,0.426,0.424,97,121,0.802,134,291,425,54,37,78,128,234,767
2002-2003,Ray Allen\allenra02,SG,27,TOT,76,75,2880,598,1363,0.439,201,533,0.377,397,830,0.478,0.512,316,345,0.916,94,287,381,334,103,14,198,220,1713
2002-2003,Ray Allen\allenra02,SG,27,MIL,47,46,1683,351,803,0.437,123,311,0.395,228,492,0.463,0.514,178,195,0.913,45,173,218,164,57,11,117,149,1003
2002-2003,Ray Allen\allenra02,SG,27,SEA,29,29,1197,247,560,0.441,78,222,0.351,169,338,0.5,0.511,138,150,0.92,49,114,163,170,46,3,81,71,710
2002-2003,Rafer Alston\alstora01,PG,26,TOR,47,4,980,139,335,0.415,51,130,0.392,88,205,0.429,0.491,37,54,0.685,21,86,107,192,38,15,86,120,366
2002-2003,John Amaechi\amaecjo01,C,32,UTA,50,1,474,37,118,0.314,0,0,,37,118,0.314,0.314,25,52,0.481,26,51,77,21,14,7,34,50,99
2002-2003,Chris Andersen\anderch01,C,24,DEN,59,3,907,114,285,0.4,0,1,0,114,284,0.401,0.4,77,140,0.55,109,165,274,32,30,60,60,90,305
2002-2003,Derek Anderson\anderde01,PG,28,POR,76,76,2556,355,832,0.427,116,331,0.35,239,501,0.477,0.496,231,269,0.859,53,211,264,325,90,16,128,141,1057
2002-2003,Kenny Anderson\anderke01,PG,32,TOT,61,2,1135,163,382,0.427,1,7,0.143,162,375,0.432,0.428,45,57,0.789,31,101,132,198,58,5,75,106,372
2002-2003,Kenny Anderson\anderke01,PG,32,SEA,38,1,689,102,232,0.44,0,5,0,102,227,0.449,0.44,29,35,0.829,17,70,87,121,40,1,33,63,233
2002-2003,Kenny Anderson\anderke01,PG,32,NOH,23,1,446,61,150,0.407,1,2,0.5,60,148,0.405,0.41,16,22,0.727,14,31,45,77,18,4,42,43,139
2002-2003,Shandon Anderson\andersh01,SF,29,NYK,82,9,1731,248,537,0.462,52,140,0.371,196,397,0.494,0.51,139,190,0.732,64,190,254,87,73,20,114,177,687
2002-2003,Robert Archibald\archiro01,PF,22,MEM,12,0,72,6,20,0.3,0,0,,6,20,0.3,0.3,7,18,0.389,6,11,17,3,0,3,7,9,19
2002-2003,Gilbert Arenas\arenagi01,PG,21,GSW,82,82,2866,509,1180,0.431,109,313,0.348,400,867,0.461,0.478,370,468,0.791,97,289,386,514,124,17,290,260,1497
2002-2003,Brandon Armstrong\armstbr01,SG,22,NJN,17,0,69,9,27,0.333,1,6,0.167,8,21,0.381,0.352,5,6,0.833,0,4,4,2,3,1,5,8,24
2002-2003,Darrell Armstrong\armstda01,PG,34,ORL,82,23,2350,263,643,0.409,78,232,0.336,185,411,0.45,0.47,165,188,0.878,91,204,295,323,135,13,160,167,769
2002-2003,Carlos Arroyo\arroyca01,PG,23,UTA,44,0,287,50,109,0.459,3,7,0.429,47,102,0.461,0.472,18,22,0.818,11,15,26,53,12,1,30,28,121
2002-2003,Chucky Atkins\atkinch01,PG,28,DET,65,7,1398,168,465,0.361,86,242,0.355,82,223,0.368,0.454,40,49,0.816,21,75,96,175,27,4,77,108,462
2002-2003,Stacey Augmon\augmost01,SG,34,NOH,70,3,862,79,192,0.411,0,7,0,79,185,0.427,0.411,54,72,0.75,26,93,119,69,27,9,40,80,212
2002-2003,Dalibor Bagaric\bagarda01,C,22,CHI,10,0,76,8,26,0.308,0,0,,8,26,0.308,0.308,3,4,0.75,7,13,20,4,3,3,5,11,19
2002-2003,Vin Baker\bakervi01,C,31,BOS,52,9,942,99,207,0.478,0,4,0,99,203,0.488,0.478,72,107,0.673,90,108,198,29,22,30,61,146,270
2002-2003,Brent Barry\barrybr01,SG,31,SEA,75,68,2480,264,577,0.458,118,293,0.403,146,284,0.514,0.56,128,161,0.795,48,253,301,384,113,15,142,199,774
2002-2003,Jon Barry\barryjo01,SG,33,DET,80,0,1473,191,424,0.45,87,214,0.407,104,210,0.495,0.553,86,100,0.86,33,147,180,206,63,14,81,104,555
2002-2003,Maceo Baston\bastoma01,PF,27,TOR,16,0,106,15,25,0.6,0,0,,15,25,0.6,0.6,10,12,0.833,4,19,23,0,4,11,6,16,40
2002-2003,Mengke Bateer\bateeme01,C,27,SAS,12,0,46,4,17,0.235,1,3,0.333,3,14,0.214,0.265,0,2,0,2,8,10,4,0,0,6,14,9
2002-2003,Mike Batiste\batismi01,PF,25,MEM,75,2,1248,197,467,0.422,18,81,0.222,179,386,0.464,0.441,69,88,0.784,82,175,257,52,42,16,69,120,481
2002-2003,Tony Battie\battito01,C,26,BOS,67,62,1683,199,369,0.539,1,5,0.2,198,364,0.544,0.541,88,118,0.746,148,285,433,49,33,81,48,197,487
2002-2003,Shane Battier\battish01,SF,24,MEM,78,47,2383,275,569,0.483,86,216,0.398,189,353,0.535,0.559,120,145,0.828,128,217,345,105,102,88,68,207,756
2002-2003,Lonny Baxter\baxtelo01,C,24,CHI,55,0,682,96,206,0.466,0,2,0,96,204,0.471,0.466,70,103,0.68,65,100,165,16,9,22,46,135,262
2002-2003,Raja Bell\bellra01,SG,26,DAL,75,32,1173,93,211,0.441,21,51,0.412,72,160,0.45,0.491,23,34,0.676,47,98,145,57,52,8,43,134,230
2002-2003,Jonathan Bender\bendejo01,SF,22,IND,46,2,819,112,254,0.441,19,53,0.358,93,201,0.463,0.478,60,84,0.714,42,91,133,42,8,56,42,86,303
2002-2003,Corey Benjamin\benjaco01,SG,24,ATL,9,0,152,13,43,0.302,2,13,0.154,11,30,0.367,0.326,12,16,0.75,10,21,31,10,1,2,6,20,40
2002-2003,Travis Best\besttr01,PG,30,MIA,72,52,1807,231,583,0.396,36,109,0.33,195,474,0.411,0.427,105,123,0.854,26,121,147,255,44,7,106,174,603
2002-2003,Mike Bibby\bibbymi01,PG,24,SAC,55,55,1835,329,700,0.47,56,137,0.409,273,563,0.485,0.51,161,187,0.861,34,113,147,285,72,8,127,93,875
2002-2003,Chauncey Billups\billuch01,PG,26,DET,74,74,2327,366,870,0.421,149,380,0.392,217,490,0.443,0.506,318,362,0.878,38,235,273,287,63,15,134,136,1199
2002-2003,Corie Blount\blounco01,C,34,CHI,50,3,836,65,134,0.485,0,0,,65,134,0.485,0.485,20,35,0.571,68,137,205,50,33,19,43,121,150
2002-2003,Mark Blount\blounma01,C,27,TOT,81,31,1403,150,347,0.432,0,0,,150,347,0.432,0.432,101,139,0.727,111,197,308,56,42,68,103,187,401
2002-2003,Mark Blount\blounma01,C,27,DEN,54,24,885,105,267,0.393,0,0,,105,267,0.393,0.393,71,99,0.717,62,121,183,35,22,51,70,112,281
2002-2003,Mark Blount\blounma01,C,27,BOS,27,7,518,45,80,0.563,0,0,,45,80,0.563,0.563,30,40,0.75,49,76,125,21,20,17,33,75,120
2002-2003,Calvin Booth\boothca01,C,26,SEA,47,0,575,52,119,0.437,0,2,0,52,117,0.444,0.437,34,47,0.723,32,77,109,12,11,33,22,74,138
2002-2003,Carlos Boozer\boozeca01,PF,21,CLE,81,54,2049,331,618,0.536,0,1,0,331,617,0.536,0.536,148,192,0.771,202,407,609,106,59,50,103,224,810
2002-2003,Ruben Boumtje-Boumtje\boumtru01,C,24,POR,2,0,5,0,1,0,0,0,,0,1,0,0,0,0,,1,0,1,1,1,0,0,0,0
2002-2003,Bruce Bowen\bowenbr01,SF,31,SAS,82,82,2566,223,479,0.466,101,229,0.441,122,250,0.488,0.571,36,89,0.404,59,180,239,113,66,42,72,195,583
2002-2003,Ryan Bowen\bowenry01,SG,27,DEN,62,31,996,97,197,0.492,2,7,0.286,95,190,0.5,0.497,27,41,0.659,78,79,157,54,65,29,43,82,223
2002-2003,Earl Boykins\boykiea01,PG,26,GSW,68,0,1321,199,464,0.429,29,77,0.377,170,387,0.439,0.46,173,200,0.865,35,53,88,221,38,4,73,75,600
2002-2003,Michael Bradley\bradlmi01,PF,23,TOR,67,11,1314,151,314,0.481,1,6,0.167,150,308,0.487,0.482,35,67,0.522,162,247,409,67,16,32,76,125,338
2002-2003,Shawn Bradley\bradlsh01,C,30,DAL,81,39,1731,201,375,0.536,0,1,0,201,374,0.537,0.536,141,175,0.806,151,325,476,54,65,170,67,242,543
2002-2003,Elton Brand\brandel01,PF,23,LAC,62,61,2454,451,899,0.502,0,1,0,451,898,0.502,0.502,244,356,0.685,283,420,703,157,71,158,161,204,1146
2002-2003,J.R. Bremer\bremejr01,PG,22,BOS,64,41,1503,171,464,0.369,101,286,0.353,70,178,0.393,0.477,85,111,0.766,18,127,145,164,38,3,59,80,528
2002-2003,Jamison Brewer\breweja01,PG,22,IND,10,0,80,9,17,0.529,0,2,0,9,15,0.6,0.529,4,9,0.444,5,4,9,18,2,1,6,11,22
2002-2003,Primoz Brezec\brezepr01,C,23,IND,22,1,111,15,38,0.395,0,1,0,15,37,0.405,0.395,12,20,0.6,13,10,23,4,2,4,7,16,42
2002-2003,Damone Brown\brownda02,PF,23,TOR,5,3,115,11,35,0.314,0,2,0,11,33,0.333,0.314,6,8,0.75,3,12,15,3,1,0,6,14,28
2002-2003,Devin Brown\brownde02,SG,24,TOT,10,2,93,12,35,0.343,0,1,0,12,34,0.353,0.343,6,8,0.75,8,10,18,7,4,1,9,14,30
2002-2003,Devin Brown\brownde02,SG,24,SAS,7,0,22,5,10,0.5,0,0,,5,10,0.5,0.5,2,2,1,4,3,7,2,0,0,5,3,12
2002-2003,Devin Brown\brownde02,SG,24,DEN,3,2,71,7,25,0.28,0,1,0,7,24,0.292,0.28,4,6,0.667,4,7,11,5,4,1,4,11,18
2002-2003,Kedrick Brown\brownke01,SF,21,BOS,51,5,666,61,171,0.357,3,39,0.077,58,132,0.439,0.365,20,32,0.625,45,95,140,20,34,13,23,68,145
2002-2003,Kwame Brown\brownkw01,C,20,WAS,80,20,1773,224,502,0.446,0,3,0,224,499,0.449,0.446,145,217,0.668,128,298,426,58,50,80,110,159,593
2002-2003,P.J. Brown\brownpj01,PF,33,NOH,78,78,2609,319,601,0.531,0,3,0,319,598,0.533,0.531,194,232,0.836,243,458,701,147,67,80,98,203,832
2002-2003,Randy Brown\brownra02,PG,34,PHO,32,0,262,16,43,0.372,0,0,,16,43,0.372,0.372,9,12,0.75,3,23,26,35,17,2,17,36,41
2002-2003,Tierre Brown\brownti01,PG,23,CLE,15,0,168,27,59,0.458,0,1,0,27,58,0.466,0.458,11,14,0.786,8,22,30,39,13,0,22,9,65
2002-2003,Rick Brunson\brunsri01,PG,30,CHI,17,0,196,23,50,0.46,4,6,0.667,19,44,0.432,0.5,10,12,0.833,4,15,19,36,10,3,17,20,60
2002-2003,Kobe Bryant\bryanko01,SG,24,LAL,82,82,3401,868,1924,0.451,124,324,0.383,744,1600,0.465,0.483,601,713,0.843,106,458,564,481,181,67,288,218,2461
2002-2003,Mark Bryant\bryanma01,PF,37,TOT,16,0,100,5,19,0.263,0,0,,5,19,0.263,0.263,3,4,0.75,8,12,20,4,1,1,7,18,13
2002-2003,Mark Bryant\bryanma01,PF,37,PHI,11,0,77,5,17,0.294,0,0,,5,17,0.294,0.294,2,2,1,7,9,16,1,1,1,5,12,12
2002-2003,Mark Bryant\bryanma01,PF,37,DEN,3,0,14,0,1,0,0,0,,0,1,0,0,1,2,0.5,1,1,2,2,0,0,2,4,1
2002-2003,Mark Bryant\bryanma01,PF,37,BOS,2,0,9,0,1,0,0,0,,0,1,0,0,0,0,,0,2,2,1,0,0,0,2,0
2002-2003,Greg Buckner\buckngr01,SG,26,PHI,75,5,1514,185,398,0.465,15,55,0.273,170,343,0.496,0.484,65,81,0.802,72,144,216,96,72,16,62,203,450
2002-2003,Pat Burke\burkepa01,C,29,ORL,62,8,783,113,296,0.382,1,7,0.143,112,289,0.388,0.383,40,58,0.69,57,89,146,23,19,25,47,99,267
2002-2003,Caron Butler\butleca01,SF,22,MIA,78,78,2858,429,1032,0.416,34,107,0.318,395,925,0.427,0.432,309,375,0.824,135,262,397,213,137,31,192,230,1201
2002-2003,Rasual Butler\butlera01,SG,23,MIA,72,28,1514,207,572,0.362,50,171,0.292,157,401,0.392,0.406,76,104,0.731,29,157,186,93,21,43,77,105,540
2002-2003,Jason Caffey\caffeja01,PF,29,MIL,51,16,894,113,248,0.456,0,0,,113,248,0.456,0.456,69,106,0.651,68,108,176,38,19,15,56,122,295
2002-2003,Marcus Camby\cambyma01,C,28,DEN,29,9,616,93,227,0.41,2,5,0.4,91,222,0.41,0.414,33,50,0.66,75,133,208,47,20,40,27,69,221
2002-2003,Elden Campbell\campbel01,C,34,TOT,56,1,869,117,295,0.397,0,1,0,117,294,0.398,0.397,109,136,0.801,47,134,181,51,33,39,50,129,343
2002-2003,Elden Campbell\campbel01,C,34,NOH,41,1,685,101,247,0.409,0,1,0,101,246,0.411,0.409,93,115,0.809,34,108,142,42,24,31,42,102,295
2002-2003,Elden Campbell\campbel01,C,34,SEA,15,0,184,16,48,0.333,0,0,,16,48,0.333,0.333,16,21,0.762,13,26,39,9,9,8,8,27,48
2002-2003,Brian Cardinal\cardibr01,PF,25,WAS,5,0,15,1,4,0.25,0,1,0,1,3,0.333,0.25,2,2,1,3,2,5,1,0,0,1,0,4
2002-2003,Anthony Carter\cartean01,PG,27,MIA,49,26,912,83,233,0.356,0,8,0,83,225,0.369,0.356,33,50,0.66,12,71,83,203,45,5,81,70,199
2002-2003,Vince Carter\cartevi01,SG,26,TOR,43,42,1471,355,760,0.467,45,131,0.344,310,629,0.493,0.497,129,160,0.806,59,129,188,143,48,41,74,121,884
2002-2003,Sam Cassell\cassesa01,PG,33,MIL,78,77,2700,546,1162,0.47,59,163,0.362,487,999,0.487,0.495,385,447,0.861,57,285,342,450,88,14,177,216,1536
2002-2003,Kelvin Cato\catoke01,C,28,HOU,73,5,1247,133,256,0.52,0,4,0,133,252,0.528,0.52,66,124,0.532,132,296,428,20,38,85,56,176,332
2002-2003,Tyson Chandler\chandty01,C,20,CHI,75,68,1827,257,484,0.531,0,0,,257,484,0.531,0.531,177,291,0.608,169,345,514,76,37,106,135,220,691
2002-2003,Calbert Cheaney\cheanca01,SG,31,UTA,81,74,2351,325,651,0.499,10,25,0.4,315,626,0.503,0.507,40,69,0.58,73,211,284,163,65,13,108,225,700
2002-2003,Chris Childs\childch01,PG,35,NJN,12,0,106,6,20,0.3,1,6,0.167,5,14,0.357,0.325,2,3,0.667,3,2,5,16,8,1,6,17,15
2002-2003,Doug Christie\chrisdo01,SG,32,SAC,80,80,2710,267,557,0.479,73,185,0.395,194,372,0.522,0.545,141,174,0.81,61,281,342,376,180,37,144,186,748
2002-2003,Keon Clark\clarkke01,C,27,SAC,80,11,1780,226,451,0.501,0,4,0,226,447,0.506,0.501,84,128,0.656,138,313,451,80,38,150,94,227,536
2002-2003,Speedy Claxton\claxtsp01,PG,24,SAS,30,0,471,67,145,0.462,0,11,0,67,134,0.5,0.462,39,57,0.684,22,34,56,75,22,7,35,43,173
2002-2003,Mateen Cleaves\cleavma01,PG,25,SAC,12,0,55,6,23,0.261,1,1,1,5,22,0.227,0.283,3,4,0.75,1,7,8,10,2,0,14,6,16
2002-2003,Derrick Coleman\colemde01,C,35,PHI,64,35,1742,223,498,0.448,22,67,0.328,201,431,0.466,0.47,134,171,0.784,151,299,450,87,53,69,96,171,602
2002-2003,Bimbo Coles\colesbi01,PG,34,TOT,35,11,691,56,168,0.333,7,32,0.219,49,136,0.36,0.354,35,42,0.833,11,48,59,72,17,4,28,60,154
2002-2003,Bimbo Coles\colesbi01,PG,34,CLE,21,11,516,34,119,0.286,7,25,0.28,27,94,0.287,0.315,27,34,0.794,10,38,48,56,11,4,18,43,102
2002-2003,Bimbo Coles\colesbi01,PG,34,BOS,14,0,175,22,49,0.449,0,7,0,22,42,0.524,0.449,8,8,1,1,10,11,16,6,0,10,17,52
2002-2003,Jason Collier\collija02,C,25,HOU,13,3,104,17,36,0.472,0,0,,17,36,0.472,0.472,2,2,1,12,17,29,1,2,1,2,10,36
2002-2003,Jarron Collins\collija03,C,24,UTA,22,7,421,38,86,0.442,0,1,0,38,85,0.447,0.442,44,62,0.71,32,28,60,14,5,6,19,70,120
2002-2003,Jason Collins\collija04,C,24,NJN,81,66,1900,140,338,0.414,0,4,0,140,334,0.419,0.414,180,236,0.763,136,232,368,87,47,44,85,252,460
2002-2003,Chris Crawford\crawfch01,PF,27,ATL,5,0,38,8,13,0.615,1,3,0.333,7,10,0.7,0.654,7,8,0.875,3,4,7,1,2,3,2,7,24
2002-2003,Jamal Crawford\crawfja01,PG,22,CHI,80,31,1992,334,808,0.413,86,242,0.355,248,566,0.438,0.467,104,129,0.806,21,164,185,334,77,25,134,126,858
2002-2003,Austin Croshere\croshau01,PF,27,IND,49,0,633,86,209,0.411,27,69,0.391,59,140,0.421,0.476,53,65,0.815,40,115,155,56,6,13,28,48,252
2002-2003,John Crotty\crottjo01,PG,33,DEN,12,0,180,14,41,0.341,4,13,0.308,10,28,0.357,0.39,9,15,0.6,1,14,15,29,3,0,9,16,41
2002-2003,Eddy Curry\curryed01,C,20,CHI,81,48,1571,335,573,0.585,0,0,,335,573,0.585,0.585,179,287,0.624,116,237,353,37,18,62,137,226,849
2002-2003,Michael Curry\currymi01,SF,34,DET,78,77,1555,92,229,0.402,16,54,0.296,76,175,0.434,0.437,36,45,0.8,16,111,127,104,44,4,43,163,236
2002-2003,Erick Dampier\dampier01,C,27,GSW,82,82,1978,259,522,0.496,0,2,0,259,520,0.498,0.496,155,222,0.698,248,295,543,58,27,154,112,242,673
2002-2003,Antonio Daniels\daniean01,SG,27,POR,67,2,872,84,186,0.452,18,59,0.305,66,127,0.52,0.5,65,76,0.855,11,61,72,85,33,9,32,43,251
2002-2003,Antonio Davis\davisan01,C,34,TOR,53,52,1894,261,641,0.407,0,0,,261,641,0.407,0.407,216,280,0.771,130,307,437,131,23,62,118,150,738
2002-2003,Baron Davis\davisba01,PG,23,NOH,50,47,1889,332,798,0.416,99,283,0.35,233,515,0.452,0.478,93,131,0.71,56,130,186,320,91,22,140,148,856
2002-2003,Dale Davis\davisda01,C,33,POR,78,78,2282,237,438,0.541,0,0,,237,438,0.541,0.541,105,166,0.633,233,331,564,94,51,70,71,189,579
2002-2003,Emanual Davis\davisem01,SG,34,ATL,24,1,340,32,88,0.364,7,29,0.241,25,59,0.424,0.403,17,22,0.773,5,38,43,36,12,2,25,28,88
2002-2003,Hubert Davis\davishu01,SG,32,DET,43,1,328,31,79,0.392,12,36,0.333,19,43,0.442,0.468,5,6,0.833,6,30,36,29,5,0,11,23,79
2002-2003,Ricky Davis\davisri01,SG,23,CLE,79,76,3131,602,1470,0.41,74,204,0.363,528,1266,0.417,0.435,348,465,0.748,97,293,390,436,125,36,277,180,1626
2002-2003,Andrew DeClercq\declean01,C,29,ORL,77,21,1327,149,279,0.534,0,0,,149,279,0.534,0.534,67,104,0.644,142,197,339,52,39,36,84,258,365
2002-2003,Tony Delk\delkto01,PG,29,BOS,67,39,1873,233,560,0.416,120,304,0.395,113,256,0.441,0.523,68,87,0.782,41,191,232,146,72,10,69,124,654
2002-2003,Dan Dickau\dickada01,PG,24,ATL,50,0,515,70,170,0.412,22,61,0.361,48,109,0.44,0.476,21,26,0.808,9,34,43,85,14,2,53,66,183
2002-2003,Michael Dickerson\dickemi01,SG,27,MEM,6,1,87,10,24,0.417,4,11,0.364,6,13,0.462,0.5,5,5,1,1,5,6,8,5,1,6,16,29
2002-2003,DeSagana Diop\diopde01,PF,21,CLE,80,1,943,54,154,0.351,0,0,,54,154,0.351,0.351,11,30,0.367,63,152,215,43,33,81,56,148,119
2002-2003,Vlade Divac\divacvl01,C,34,SAC,80,80,2384,305,655,0.466,6,25,0.24,299,630,0.475,0.47,179,251,0.713,157,417,574,274,83,105,152,239,795
2002-2003,Juan Dixon\dixonju01,PG,24,WAS,42,3,647,104,271,0.384,25,84,0.298,79,187,0.422,0.43,37,46,0.804,13,59,72,40,26,3,42,54,270
2002-2003,Michael Doleac\doleami01,C,25,NYK,75,0,1041,146,343,0.426,0,0,,146,343,0.426,0.426,36,46,0.783,65,154,219,42,16,16,49,150,328
2002-2003,Keyon Dooling\doolike01,SG,22,LAC,55,1,969,128,329,0.389,50,139,0.36,78,190,0.411,0.465,44,57,0.772,9,63,72,89,24,6,60,93,350
2002-2003,Bryce Drew\drewbr01,PG,28,NOH,13,0,79,8,27,0.296,3,7,0.429,5,20,0.25,0.352,0,0,,4,9,13,11,2,0,3,2,19
2002-2003,Predrag Drobnjak\drobnpr01,C,27,SEA,82,69,1984,325,789,0.412,30,85,0.353,295,704,0.419,0.431,91,115,0.791,111,209,320,86,48,38,65,180,771
2002-2003,Chris Dudley\dudlech02,C,37,POR,3,0,11,0,1,0,0,0,,0,1,0,0,0,0,,2,0,2,0,0,0,0,3,0
2002-2003,Tim Duncan\duncati01,PF,26,SAS,81,81,3181,714,1392,0.513,6,22,0.273,708,1370,0.517,0.515,450,634,0.71,259,784,1043,316,55,237,248,231,1884
2002-2003,Mike Dunleavy\dunlemi02,SF,22,GSW,82,3,1305,168,417,0.403,52,150,0.347,116,267,0.434,0.465,78,100,0.78,66,148,214,106,53,19,86,120,466
2002-2003,Howard Eisley\eisleho01,PG,30,NYK,82,76,2243,262,628,0.417,131,337,0.389,131,291,0.45,0.521,89,105,0.848,24,162,186,444,71,9,149,222,744
2002-2003,LaPhonso Ellis\ellisla01,PF,32,MIA,55,3,784,100,262,0.382,27,107,0.252,73,155,0.471,0.433,50,66,0.758,44,113,157,15,15,15,31,88,277
2002-2003,Melvin Ely\elyme01,C,24,LAC,52,7,802,92,186,0.495,0,0,,92,186,0.495,0.495,52,74,0.703,64,110,174,15,10,32,50,95,236
2002-2003,Evan Eschmeyer\eschmev01,C,27,DAL,17,3,135,7,19,0.368,0,0,,7,19,0.368,0.368,3,4,0.75,10,19,29,6,10,7,6,35,17
2002-2003,Reggie Evans\evansre01,PF,22,SEA,67,60,1365,66,140,0.471,0,0,,66,140,0.471,0.471,80,154,0.519,167,278,445,34,38,11,52,173,212
2002-2003,Danny Ferry\ferryda01,SF,36,SAS,64,1,601,44,124,0.355,21,60,0.35,23,64,0.359,0.44,10,13,0.769,20,55,75,21,7,9,27,55,119
2002-2003,Michael Finley\finlemi01,SF,29,DAL,69,69,2642,507,1193,0.425,119,322,0.37,388,871,0.445,0.475,198,230,0.861,107,295,402,205,76,21,114,105,1331
2002-2003,Derek Fisher\fishede01,PG,28,LAL,82,82,2829,339,775,0.437,85,212,0.401,254,563,0.451,0.492,100,125,0.8,40,199,239,298,93,15,94,195,863
2002-2003,Marcus Fizer\fizerma01,PF,24,CHI,38,0,809,178,383,0.465,1,6,0.167,177,377,0.469,0.466,88,134,0.657,80,136,216,48,14,17,57,89,445
2002-2003,Alton Ford\fordal02,PF,21,PHO,11,0,31,3,9,0.333,0,0,,3,9,0.333,0.333,1,3,0.333,0,6,6,1,0,0,2,7,7
2002-2003,Joseph Forte\fortejo01,SG,21,SEA,17,0,86,10,35,0.286,0,3,0,10,32,0.313,0.286,4,6,0.667,4,7,11,11,4,0,10,6,24
2002-2003,Danny Fortson\fortsda01,PF,26,GSW,17,0,223,20,54,0.37,0,1,0,20,53,0.377,0.37,19,29,0.655,28,45,73,12,9,0,15,43,59
2002-2003,Greg Foster\fostegr01,C,34,TOR,29,9,539,47,122,0.385,1,4,0.25,46,118,0.39,0.389,26,32,0.813,30,72,102,13,1,9,30,82,121
2002-2003,Jeff Foster\fosteje01,C,26,IND,77,2,802,64,178,0.36,0,2,0,64,176,0.364,0.36,34,63,0.54,118,161,279,51,28,21,34,103,162
2002-2003,Tremaine Fowlkes\fowlktr01,SF,26,LAC,37,10,573,56,128,0.438,2,9,0.222,54,119,0.454,0.445,50,59,0.847,41,62,103,23,25,2,20,63,164
2002-2003,Rick Fox\foxri01,SF,33,LAL,76,75,2181,262,621,0.422,105,280,0.375,157,341,0.46,0.506,52,69,0.754,64,259,323,253,69,14,121,215,681
2002-2003,Adonal Foyle\foylead01,C,27,GSW,82,0,1787,185,345,0.536,0,1,0,185,344,0.538,0.536,70,104,0.673,176,314,490,37,40,205,73,214,440
2002-2003,Steve Francis\francst01,PG,25,HOU,81,81,3318,571,1312,0.435,85,240,0.354,486,1072,0.453,0.468,476,595,0.8,159,340,499,502,141,41,299,251,1703
2002-2003,Lawrence Funderburke\fundela01,PF,32,SAC,27,0,229,32,72,0.444,0,0,,32,72,0.444,0.444,10,17,0.588,17,38,55,8,1,11,6,25,74
2002-2003,Dan Gadzuric\gadzuda01,C,24,MIL,49,30,760,70,145,0.483,0,1,0,70,144,0.486,0.483,29,56,0.518,66,131,197,9,22,52,27,125,169
2002-2003,Kevin Garnett\garneke01,PF,26,MIN,82,82,3321,743,1481,0.502,20,71,0.282,723,1410,0.513,0.508,377,502,0.751,244,858,1102,495,113,129,229,199,1883
2002-2003,Pat Garrity\garripa01,PF,26,ORL,81,53,2584,312,744,0.419,161,407,0.396,151,337,0.448,0.528,83,100,0.83,72,234,306,121,62,20,77,255,868
2002-2003,Pau Gasol\gasolpa01,PF,22,MEM,82,82,2948,569,1116,0.51,1,10,0.1,568,1106,0.514,0.51,416,565,0.736,192,528,720,229,34,148,213,220,1555
2002-2003,Devean George\georgde01,SF,25,LAL,71,7,1613,180,461,0.39,49,132,0.371,131,329,0.398,0.444,83,105,0.79,91,195,286,92,56,38,65,180,492
2002-2003,Kendall Gill\gillke01,SG,34,MIN,82,34,2068,286,677,0.422,19,59,0.322,267,618,0.432,0.436,123,161,0.764,51,197,248,156,78,15,108,176,714
2002-2003,Manu Ginobili\ginobma01,SG,25,SAS,69,5,1431,174,397,0.438,51,148,0.345,123,249,0.494,0.503,126,171,0.737,47,114,161,138,96,17,100,170,525
2002-2003,Gordan Giricek\giricgo01,SG-SF,25,TOT,76,62,2148,350,803,0.436,85,249,0.341,265,554,0.478,0.489,150,183,0.82,36,202,238,137,52,8,145,159,935
2002-2003,Gordan Giricek\giricgo01,SG,25,MEM,49,35,1187,207,478,0.433,46,130,0.354,161,348,0.463,0.481,88,107,0.822,18,90,108,70,22,6,94,104,548
2002-2003,Gordan Giricek\giricgo01,SF,25,ORL,27,27,961,143,325,0.44,39,119,0.328,104,206,0.505,0.5,62,76,0.816,18,112,130,67,30,2,51,55,387
2002-2003,Dion Glover\glovedi01,SG,24,ATL,76,42,1890,277,648,0.427,56,158,0.354,221,490,0.451,0.471,127,162,0.784,62,220,282,141,71,15,108,146,737
2002-2003,Anthony Goldwire\goldwan01,PG,31,TOT,15,0,85,9,25,0.36,3,9,0.333,6,16,0.375,0.42,4,7,0.571,0,6,6,4,3,0,6,6,25
2002-2003,Anthony Goldwire\goldwan01,PG,31,SAS,10,0,51,5,18,0.278,2,8,0.25,3,10,0.3,0.333,0,2,0,0,3,3,3,3,0,2,5,12
2002-2003,Anthony Goldwire\goldwan01,PG,31,WAS,5,0,34,4,7,0.571,1,1,1,3,6,0.5,0.643,4,5,0.8,0,3,3,1,0,0,4,1,13
2002-2003,Drew Gooden\goodedr01,SF-PF,21,TOT,70,47,1873,355,777,0.457,14,48,0.292,341,729,0.468,0.466,151,212,0.712,163,292,455,83,53,35,150,172,875
2002-2003,Drew Gooden\goodedr01,SF,21,MEM,51,29,1329,255,576,0.443,14,46,0.304,241,530,0.455,0.455,92,132,0.697,105,190,295,63,38,22,105,121,616
2002-2003,Drew Gooden\goodedr01,PF,21,ORL,19,18,544,100,201,0.498,0,2,0,100,199,0.503,0.498,59,80,0.738,58,102,160,20,15,13,45,51,259
2002-2003,Brian Grant\grantbr01,C,30,MIA,82,82,2641,344,676,0.509,0,0,,344,676,0.509,0.509,158,205,0.771,241,596,837,104,63,47,129,300,846
2002-2003,Horace Grant\grantho01,PF,37,ORL,5,1,85,13,25,0.52,0,0,,13,25,0.52,0.52,0,0,,2,6,8,7,3,0,1,5,26
2002-2003,Adrian Griffin\griffad01,SG,28,DAL,74,48,1373,146,337,0.433,6,24,0.25,140,313,0.447,0.442,27,32,0.844,88,176,264,105,77,6,47,157,325
2002-2003,Eddie Griffin\griffed01,PF,20,HOU,77,66,1890,271,678,0.4,64,192,0.333,207,486,0.426,0.447,58,94,0.617,138,323,461,86,52,111,76,136,664
2002-2003,Tom Gugliotta\guglito01,PF,33,PHO,27,11,447,60,132,0.455,0,1,0,60,131,0.458,0.455,9,9,1,25,75,100,31,14,5,31,35,129
2002-2003,A.J. Guyton\guytoaj01,PG,24,GSW,2,0,9,0,4,0,0,1,0,0,3,0,0,0,0,,0,0,0,2,1,0,1,0,0
2002-2003,Marcus Haislip\haislma01,PF,22,MIL,39,8,441,66,153,0.431,3,12,0.25,63,141,0.447,0.441,26,38,0.684,21,32,53,9,7,18,21,55,161
2002-2003,Darvin Ham\hamda01,SG,29,ATL,75,1,926,71,159,0.447,0,3,0,71,156,0.455,0.447,38,79,0.481,73,80,153,38,16,19,65,127,180
2002-2003,Richard Hamilton\hamilri01,SG,24,DET,82,82,2640,570,1286,0.443,32,119,0.269,538,1167,0.461,0.456,440,528,0.833,88,230,318,208,64,13,200,249,1612
2002-2003,Zendon Hamilton\hamilze01,C,27,TOR,3,0,12,2,5,0.4,0,0,,2,5,0.4,0.4,2,2,1,1,3,4,0,1,0,1,2,6
2002-2003,Anfernee Hardaway\hardaan01,SG,31,PHO,58,51,1777,256,573,0.447,26,73,0.356,230,500,0.46,0.469,77,97,0.794,66,192,258,235,66,26,145,150,615
2002-2003,Tim Hardaway\hardati01,PG,36,IND,10,0,127,18,49,0.367,11,31,0.355,7,18,0.389,0.48,2,4,0.5,1,14,15,24,9,0,11,8,49
2002-2003,Matt Harpring\harprma01,SF,26,UTA,78,69,2557,521,1020,0.511,66,160,0.413,455,860,0.529,0.543,262,331,0.792,190,324,514,133,73,17,160,217,1370
2002-2003,Adam Harrington\harriad01,SG,22,TOT,19,0,111,11,37,0.297,5,14,0.357,6,23,0.261,0.365,3,4,0.75,1,7,8,12,2,1,2,8,30
2002-2003,Adam Harrington\harriad01,SG,22,DAL,13,0,37,4,17,0.235,1,3,0.333,3,14,0.214,0.265,2,2,1,0,2,2,2,1,1,2,2,11
2002-2003,Adam Harrington\harriad01,SG,22,DEN,6,0,74,7,20,0.35,4,11,0.364,3,9,0.333,0.45,1,2,0.5,1,5,6,10,1,0,0,6,19
2002-2003,Al Harrington\harrial01,SF,22,IND,82,37,2467,389,896,0.434,13,46,0.283,376,850,0.442,0.441,211,274,0.77,159,352,511,125,71,33,163,280,1002
2002-2003,Junior Harrington\harriju01,PG,22,DEN,82,51,2003,169,467,0.362,7,28,0.25,162,439,0.369,0.369,73,112,0.652,44,206,250,277,80,15,157,250,418
2002-2003,Othella Harrington\harriot01,PF,29,NYK,74,64,1850,225,443,0.508,0,0,,225,443,0.508,0.508,123,150,0.82,165,311,476,62,12,23,90,231,573
2002-2003,Lucious Harris\harrilu01,SG,32,NJN,77,25,1973,298,721,0.413,47,136,0.346,251,585,0.429,0.446,152,189,0.804,63,169,232,155,53,8,71,95,795
2002-2003,Antonio Harvey\harvean01,PF,32,ATL,4,0,32,2,5,0.4,0,0,,2,5,0.4,0.4,0,0,,1,5,6,0,1,4,3,7,4
2002-2003,Donnell Harvey\harvedo01,SF,22,DEN,77,27,1613,246,551,0.446,1,7,0.143,245,544,0.45,0.447,118,176,0.67,125,284,409,100,48,27,123,203,611
2002-2003,Trenton Hassell\hassetr01,SG,23,CHI,82,53,1999,144,392,0.367,13,40,0.325,131,352,0.372,0.384,41,55,0.745,37,218,255,151,45,61,83,197,342
2002-2003,Kirk Haston\hastoki01,SF,23,NOH,12,0,57,2,17,0.118,0,3,0,2,14,0.143,0.118,2,4,0.5,0,7,7,3,0,5,7,10,6
2002-2003,Juaquin Hawkins\hawkiju01,SG,29,HOU,58,10,685,57,148,0.385,10,24,0.417,47,124,0.379,0.419,10,20,0.5,16,62,78,47,29,6,29,57,134
2002-2003,Brendan Haywood\haywobr01,C,23,WAS,81,69,1930,173,339,0.51,0,0,,173,339,0.51,0.51,155,245,0.633,192,212,404,29,32,119,65,225,501
2002-2003,Alan Henderson\hendeal01,C,30,ATL,82,3,1494,153,327,0.468,0,2,0,153,325,0.471,0.468,88,138,0.638,156,242,398,41,33,32,61,168,394
2002-2003,Nene Hilario\hilarne01,C,20,DEN,80,53,2258,321,619,0.519,0,3,0,321,616,0.521,0.519,197,341,0.578,208,283,491,149,127,65,181,295,839
2002-2003,Grant Hill\hillgr01,SF,30,ORL,29,29,843,151,307,0.492,1,4,0.25,150,303,0.495,0.493,118,144,0.819,40,166,206,122,28,13,84,46,421
2002-2003,Tyrone Hill\hillty01,PF,34,TOT,56,43,1351,129,306,0.422,0,0,,129,306,0.422,0.422,54,80,0.675,126,265,391,41,46,26,68,172,312
2002-2003,Tyrone Hill\hillty01,PF,34,CLE,32,25,855,85,197,0.431,0,0,,85,197,0.431,0.431,33,45,0.733,70,197,267,32,31,19,52,104,203
2002-2003,Tyrone Hill\hillty01,PF,34,PHI,24,18,496,44,109,0.404,0,0,,44,109,0.404,0.404,21,35,0.6,56,68,124,9,15,7,16,68,109
2002-2003,Fred Hoiberg\hoibefr01,SG,30,CHI,63,0,784,49,126,0.389,5,21,0.238,44,105,0.419,0.409,41,50,0.82,11,126,137,70,40,5,25,59,144
2002-2003,Robert Horry\horryro01,PF,32,LAL,80,26,2343,184,476,0.387,51,177,0.288,133,299,0.445,0.44,103,134,0.769,181,333,514,233,96,61,112,247,522
2002-2003,Eddie House\houseed01,SG,24,MIA,55,7,1025,172,444,0.387,36,120,0.3,136,324,0.42,0.428,31,36,0.861,17,84,101,87,44,1,46,73,411
2002-2003,Allan Houston\houstal01,SG,31,NYK,82,82,3108,652,1465,0.445,178,450,0.396,474,1015,0.467,0.506,363,395,0.919,26,205,231,220,54,7,178,191,1845
2002-2003,Juwan Howard\howarju01,PF,29,DEN,77,77,2730,567,1261,0.45,2,4,0.5,565,1257,0.449,0.45,282,351,0.803,181,404,585,234,77,27,189,239,1418
2002-2003,Troy Hudson\hudsotr01,PG,26,MIN,79,74,2600,409,956,0.428,97,266,0.365,312,690,0.452,0.479,208,231,0.9,42,141,183,452,60,7,182,160,1123
2002-2003,Nate Huffman\huffmna01,C,27,TOR,7,0,76,9,25,0.36,0,0,,9,25,0.36,0.36,5,8,0.625,9,14,23,5,1,3,3,13,23
2002-2003,Larry Hughes\hughela01,PG,24,WAS,67,56,2137,346,741,0.467,29,79,0.367,317,662,0.479,0.487,136,186,0.731,67,241,308,205,86,24,136,149,857
2002-2003,Ryan Humphrey\humphry01,PF,23,TOT,48,1,444,35,120,0.292,0,0,,35,120,0.292,0.292,23,39,0.59,34,65,99,11,9,18,23,75,93
2002-2003,Ryan Humphrey\humphry01,PF,23,ORL,35,1,322,23,85,0.271,0,0,,23,85,0.271,0.271,18,28,0.643,30,39,69,7,4,16,21,57,64
2002-2003,Ryan Humphrey\humphry01,PF,23,MEM,13,0,122,12,35,0.343,0,0,,12,35,0.343,0.343,5,11,0.455,4,26,30,4,5,2,2,18,29
2002-2003,Lindsey Hunter\hunteli01,PG,32,TOR,29,0,673,106,302,0.351,34,107,0.318,72,195,0.369,0.407,34,47,0.723,15,44,59,71,35,5,57,50,280
2002-2003,Steven Hunter\huntest01,C,21,ORL,33,5,447,56,103,0.544,0,0,,56,103,0.544,0.544,18,44,0.409,38,55,93,6,9,36,15,56,130
2002-2003,Zydrunas Ilgauskas\ilgauzy01,C,27,CLE,81,81,2432,495,1122,0.441,0,5,0,495,1117,0.443,0.441,400,512,0.781,240,371,611,127,56,152,210,274,1390
2002-2003,Allen Iverson*\iversal01,SG,27,PHI,82,82,3485,804,1940,0.414,84,303,0.277,720,1637,0.44,0.436,570,736,0.774,68,276,344,454,225,13,286,149,2262
2002-2003,Bobby Jackson\jacksbo01,PG,29,SAC,59,26,1676,340,732,0.464,89,235,0.379,251,497,0.505,0.525,126,149,0.846,57,162,219,182,71,3,106,126,895
2002-2003,Jermaine Jackson\jacksje01,SG,26,TOT,53,1,559,40,110,0.364,1,10,0.1,39,100,0.39,0.368,40,55,0.727,19,38,57,74,19,6,34,51,121
2002-2003,Jermaine Jackson\jacksje01,SG,26,TOR,24,1,286,21,68,0.309,1,9,0.111,20,59,0.339,0.316,23,27,0.852,10,15,25,39,9,3,19,24,66
2002-2003,Jermaine Jackson\jacksje01,SG,26,ATL,29,0,273,19,42,0.452,0,1,0,19,41,0.463,0.452,17,28,0.607,9,23,32,35,10,3,15,27,55
2002-2003,Jim Jackson\jacksji01,SF,32,SAC,63,0,1309,204,462,0.442,32,71,0.451,172,391,0.44,0.476,47,55,0.855,84,178,262,118,31,4,80,132,487
2002-2003,Marc Jackson\jacksma02,C,28,MIN,77,0,1041,153,349,0.438,1,1,1,152,348,0.437,0.44,114,149,0.765,86,139,225,37,24,30,59,137,421
2002-2003,Mark Jackson\jacksma01,PG,37,UTA,82,0,1467,147,369,0.398,27,95,0.284,120,274,0.438,0.435,61,80,0.763,34,142,176,375,48,3,152,90,382
2002-2003,Stephen Jackson\jacksst02,SG,24,SAS,80,58,2254,356,818,0.435,95,297,0.32,261,521,0.501,0.493,139,183,0.76,66,220,286,183,125,30,176,202,946
2002-2003,Casey Jacobsen\jacobca01,SF,21,PHO,72,0,1147,122,327,0.373,52,165,0.315,70,162,0.432,0.453,72,105,0.686,29,54,83,73,35,6,55,90,368
2002-2003,Jerome James\jamesje01,C,27,SEA,51,16,766,111,232,0.478,0,0,,111,232,0.478,0.478,54,92,0.587,78,138,216,27,12,82,75,166,276
2002-2003,Mike James\jamesmi01,PG,27,MIA,78,8,1722,218,585,0.373,67,228,0.294,151,357,0.423,0.43,104,142,0.732,26,123,149,246,64,5,108,176,607
2002-2003,Antawn Jamison\jamisan01,SF,26,GSW,82,82,3226,691,1471,0.47,65,209,0.311,626,1262,0.496,0.492,375,475,0.789,195,383,578,156,76,45,177,197,1822
2002-2003,Marko Jaric\jaricma01,SF,24,LAC,66,12,1379,179,446,0.401,53,166,0.319,126,280,0.45,0.461,79,105,0.752,35,125,160,193,97,11,103,125,490
2002-2003,Chris Jefferies\jeffech01,SF,22,TOR,51,10,666,75,194,0.387,18,54,0.333,57,140,0.407,0.433,29,43,0.674,16,43,59,22,19,16,45,56,197
2002-2003,Richard Jefferson\jefferi01,SF,22,NJN,80,80,2879,456,911,0.501,6,24,0.25,450,887,0.507,0.504,324,436,0.743,150,364,514,201,80,44,156,216,1242
2002-2003,Jared Jeffries\jeffrja01,SF,21,WAS,20,1,292,30,63,0.476,3,6,0.5,27,57,0.474,0.5,16,29,0.552,26,32,58,16,8,5,21,28,79
2002-2003,Anthony Johnson\johnsan02,PG,28,NJN,66,2,842,103,231,0.446,13,35,0.371,90,196,0.459,0.474,51,74,0.689,13,65,78,86,37,5,41,93,270
2002-2003,Avery Johnson\johnsav01,PG,37,DAL,48,0,430,63,150,0.42,0,2,0,63,148,0.426,0.42,30,39,0.769,10,21,31,64,15,1,29,26,156
2002-2003,Ervin Johnson\johnser02,C,35,MIL,69,17,1170,61,135,0.452,0,0,,61,135,0.452,0.452,30,44,0.682,117,177,294,24,34,63,34,178,152
2002-2003,Joe Johnson\johnsjo02,SG,21,PHO,82,34,2255,316,796,0.397,75,205,0.366,241,591,0.408,0.444,96,124,0.774,57,207,264,210,62,19,108,143,803
2002-2003,Ken Johnson\johnske03,C,24,MIA,16,0,156,15,37,0.405,0,0,,15,37,0.405,0.405,2,6,0.333,4,28,32,0,1,12,6,20,32
2002-2003,Damon Jones\jonesda01,PG,26,SAC,49,1,709,80,210,0.381,44,121,0.364,36,89,0.404,0.486,20,27,0.741,11,59,70,80,18,4,23,42,224
2002-2003,Eddie Jones\jonesed02,SG,31,MIA,47,47,1789,291,688,0.423,98,241,0.407,193,447,0.432,0.494,189,230,0.822,35,191,226,173,64,31,85,137,869
2002-2003,Fred Jones\jonesfr01,SG,23,IND,19,1,115,9,24,0.375,2,7,0.286,7,17,0.412,0.417,3,4,0.75,4,5,9,5,6,1,6,13,23
2002-2003,Jumaine Jones\jonesju01,SF,23,CLE,80,12,2204,308,710,0.434,111,314,0.354,197,396,0.497,0.512,57,83,0.687,106,299,405,112,67,22,107,176,784
2002-2003,Popeye Jones\jonespo01,PF,32,DAL,26,0,222,24,62,0.387,0,0,,24,62,0.387,0.387,5,11,0.455,29,30,59,8,5,1,15,31,53
2002-2003,Michael Jordan*\jordami01,SF,39,WAS,82,67,3031,679,1527,0.445,16,55,0.291,663,1472,0.45,0.45,266,324,0.821,71,426,497,311,123,39,173,171,1640
2002-2003,Shawn Kemp\kempsh01,C,33,ORL,79,55,1633,211,505,0.418,0,1,0,211,504,0.419,0.418,115,155,0.742,147,304,451,55,66,33,102,239,537
2002-2003,Steve Kerr\kerrst01,PG,37,SAS,75,0,952,110,256,0.43,49,124,0.395,61,132,0.462,0.525,30,34,0.882,12,48,60,70,27,3,35,49,299
2002-2003,Jason Kidd\kiddja01,PG,29,NJN,80,80,2989,515,1244,0.414,126,370,0.341,389,874,0.445,0.465,339,403,0.841,110,394,504,711,179,25,296,127,1495
2002-2003,Andrei Kirilenko\kirilan01,SF,21,UTA,80,11,2213,315,642,0.491,37,114,0.325,278,528,0.527,0.519,296,370,0.8,147,273,420,138,118,175,136,185,963
2002-2003,Kerry Kittles\kittlke01,SG,28,NJN,65,57,1951,332,711,0.467,78,219,0.356,254,492,0.516,0.522,106,135,0.785,52,200,252,170,101,30,55,110,848
2002-2003,Brevin Knight\knighbr01,PG,27,MEM,55,4,928,97,228,0.425,2,8,0.25,95,220,0.432,0.43,20,37,0.541,15,66,81,233,69,2,94,123,216
2002-2003,Travis Knight\knightr01,C,28,NYK,32,0,287,25,65,0.385,0,1,0,25,64,0.391,0.385,10,13,0.769,18,44,62,14,8,9,10,44,60
2002-2003,Toni Kukoc\kukocto01,PF,34,MIL,63,0,1704,249,577,0.432,95,263,0.361,154,314,0.49,0.514,137,194,0.706,67,199,266,230,81,29,122,134,730
2002-2003,Christian Laettner\laettch01,PF,33,WAS,76,66,2215,255,516,0.494,2,16,0.125,253,500,0.506,0.496,120,144,0.833,114,388,502,235,82,40,87,206,632
2002-2003,Raef LaFrentz\lafrera01,C,26,DAL,69,43,1611,266,514,0.518,47,116,0.405,219,398,0.55,0.563,60,88,0.682,125,205,330,54,35,91,46,264,639
2002-2003,Sean Lampley\lamplse01,SF,23,MIA,35,0,487,56,129,0.434,0,4,0,56,125,0.448,0.434,57,82,0.695,26,57,83,31,7,3,25,43,169
2002-2003,Dan Langhi\langhda01,SF,25,PHO,60,0,541,81,202,0.401,9,31,0.29,72,171,0.421,0.423,12,20,0.6,19,68,87,21,15,6,16,58,183
2002-2003,Voshon Lenard\lenarvo01,SG,29,TOR,63,24,1929,325,809,0.402,92,252,0.365,233,557,0.418,0.459,156,194,0.804,48,164,212,144,59,21,103,156,898
2002-2003,Rashard Lewis\lewisra02,SF,23,SEA,77,77,3044,519,1149,0.452,75,217,0.346,444,932,0.476,0.484,283,345,0.82,152,351,503,133,99,35,143,205,1396
2002-2003,Randy Livingston\livinra01,PG,27,NOH,2,0,12,2,4,0.5,0,0,,2,4,0.5,0.5,2,2,1,0,0,0,1,0,0,0,0,6
2002-2003,Art Long\longar01,SF,30,TOT,26,0,211,28,75,0.373,2,3,0.667,26,72,0.361,0.387,2,10,0.2,21,39,60,6,5,11,20,35,60
2002-2003,Art Long\longar01,SF,30,PHI,19,0,131,19,50,0.38,1,1,1,18,49,0.367,0.39,1,5,0.2,13,27,40,2,2,8,9,22,40
2002-2003,Art Long\longar01,SF,30,TOR,7,0,80,9,25,0.36,1,2,0.5,8,23,0.348,0.38,1,5,0.2,8,12,20,4,3,3,11,13,20
2002-2003,Grant Long\longgr01,PF,36,BOS,41,1,488,27,70,0.386,0,3,0,27,67,0.403,0.386,18,23,0.783,24,59,83,25,9,1,19,62,72
2002-2003,Tyronn Lue\luety01,PG,25,WAS,75,24,1986,248,573,0.433,60,176,0.341,188,397,0.474,0.485,91,104,0.875,22,127,149,263,47,1,77,151,647
2002-2003,George Lynch\lynchge01,SG,32,NOH,81,32,1497,147,359,0.409,28,79,0.354,119,280,0.425,0.448,41,74,0.554,139,214,353,104,66,19,52,136,363
2002-2003,Todd MacCulloch\maccuto01,C,27,PHI,42,35,812,123,238,0.517,0,0,,123,238,0.517,0.517,53,79,0.671,66,130,196,20,19,32,35,107,299
2002-2003,Tito Maddox\maddoti01,SG,21,HOU,9,0,35,3,12,0.25,0,3,0,3,9,0.333,0.25,5,8,0.625,1,6,7,5,3,1,3,4,11
2002-2003,Mark Madsen\madsema01,PF,27,LAL,54,22,781,69,163,0.423,0,0,,69,163,0.423,0.423,36,61,0.59,86,73,159,38,15,19,27,116,174
2002-2003,Corey Maggette\maggeco01,SG,23,LAC,64,57,2006,343,773,0.444,62,177,0.35,281,596,0.471,0.484,325,405,0.802,77,245,322,123,55,16,147,194,1073
2002-2003,Jamaal Magloire\magloja01,C,24,NOH,82,82,2443,305,635,0.48,0,3,0,305,632,0.483,0.48,231,322,0.717,260,464,724,88,49,111,158,276,841
2002-2003,Karl Malone*\malonka01,PF,39,UTA,81,81,2936,595,1289,0.462,3,14,0.214,592,1275,0.464,0.463,474,621,0.763,113,515,628,379,136,31,210,204,1667
2002-2003,Matt Maloney\malonma01,PG,31,ATL,14,0,103,8,25,0.32,5,15,0.333,3,10,0.3,0.42,3,5,0.6,1,6,7,17,4,0,5,9,24
2002-2003,Danny Manning\mannida01,PF,36,DET,13,0,89,13,32,0.406,3,8,0.375,10,24,0.417,0.453,5,6,0.833,7,11,18,7,9,3,7,11,34
2002-2003,Stephon Marbury\marbust01,PG,25,PHO,81,81,3240,671,1530,0.439,89,296,0.301,582,1234,0.472,0.468,375,467,0.803,53,210,263,654,108,20,263,200,1806
2002-2003,Shawn Marion\mariosh01,SF,24,PHO,81,81,3373,662,1466,0.452,141,364,0.387,521,1102,0.473,0.5,251,295,0.851,199,574,773,198,185,95,157,208,1716
2002-2003,Sean Marks\marksse01,PF,27,MIA,23,0,223,22,59,0.373,0,1,0,22,58,0.379,0.373,10,15,0.667,8,27,35,3,5,6,14,37,54
2002-2003,Donny Marshall\marshdo02,SF,30,NJN,3,0,6,0,3,0,0,1,0,0,2,0,0,0,0,,0,3,3,0,0,0,1,0,0
2002-2003,Donyell Marshall\marshdo01,PF,29,CHI,78,53,2378,421,918,0.459,33,87,0.379,388,831,0.467,0.477,167,221,0.756,234,465,699,137,95,85,135,234,1042
2002-2003,Kenyon Martin\martike01,PF,25,NJN,77,77,2628,509,1082,0.47,9,43,0.209,500,1039,0.481,0.475,256,392,0.653,164,476,640,185,98,70,192,294,1283
2002-2003,Jamal Mashburn\mashbja01,SF,30,NOH,82,81,3321,670,1586,0.422,119,306,0.389,551,1280,0.43,0.46,313,369,0.848,66,432,498,462,83,17,230,196,1772
2002-2003,Anthony Mason\masonan01,C,36,MIL,65,58,2119,191,393,0.486,0,1,0,191,392,0.487,0.486,84,117,0.718,90,326,416,209,32,12,79,147,466
2002-2003,Desmond Mason\masonde01,SF,25,TOT,80,40,2763,457,1017,0.449,21,72,0.292,436,945,0.461,0.46,212,283,0.749,154,369,523,163,67,32,115,210,1147
2002-2003,Desmond Mason\masonde01,SF,25,SEA,52,15,1811,291,667,0.436,16,55,0.291,275,612,0.449,0.448,134,181,0.74,88,247,335,95,47,21,74,136,732
2002-2003,Desmond Mason\masonde01,SF,25,MIL,28,25,952,166,350,0.474,5,17,0.294,161,333,0.483,0.481,78,102,0.765,66,122,188,68,20,11,41,74,415
2002-2003,Roger Mason\masonro01,SF,22,CHI,17,0,113,11,31,0.355,6,18,0.333,5,13,0.385,0.452,2,2,1,2,10,12,12,4,0,5,20,30
2002-2003,Tony Massenburg\masseto01,C,35,UTA,58,1,792,104,232,0.448,0,0,,104,232,0.448,0.448,65,84,0.774,59,97,156,17,17,19,50,144,273
2002-2003,Walter McCarty\mccarwa01,SF,28,BOS,82,8,1949,173,418,0.414,91,248,0.367,82,170,0.482,0.523,61,98,0.622,64,224,288,106,78,28,67,188,498
2002-2003,Amal McCaskill\mccasam01,C,29,ATL,11,0,70,4,17,0.235,0,0,,4,17,0.235,0.235,3,4,0.75,7,15,22,5,3,1,2,13,11
2002-2003,Jelani McCoy\mccoyje01,C,25,TOR,67,25,1367,194,395,0.491,0,0,,194,395,0.491,0.491,69,126,0.548,95,260,355,43,28,60,96,162,457
2002-2003,Tracy McGrady*\mcgratr01,SG,23,ORL,75,74,2954,829,1813,0.457,173,448,0.386,656,1365,0.481,0.505,576,726,0.793,121,367,488,411,124,59,195,156,2407
2002-2003,Jeff McInnis\mcinnje01,PG,28,POR,75,1,1311,188,423,0.444,6,35,0.171,182,388,0.469,0.452,50,67,0.746,22,75,97,170,21,2,75,117,432
2002-2003,Aaron McKie\mckieaa01,SF,30,PHI,80,40,2374,286,666,0.429,37,112,0.33,249,554,0.449,0.457,112,134,0.836,61,289,350,278,131,9,109,177,721
2002-2003,Stanislav Medvedenko\medvest01,PF,23,LAL,58,10,620,112,258,0.434,0,2,0,112,256,0.438,0.434,31,43,0.721,66,75,141,18,11,8,37,118,255
2002-2003,Ron Mercer\mercero01,SG,26,IND,72,3,1671,244,597,0.409,3,16,0.188,241,581,0.415,0.411,65,81,0.802,32,122,154,112,49,14,54,123,556
2002-2003,Chris Mihm\mihmch01,C,23,CLE,52,0,809,116,287,0.404,0,3,0,116,284,0.408,0.404,76,105,0.724,93,138,231,28,18,38,48,124,308
2002-2003,Darius Miles\milesda01,SF,21,CLE,67,62,2008,263,642,0.41,0,14,0,263,628,0.419,0.41,92,155,0.594,113,250,363,176,67,69,178,159,618
2002-2003,Andre Miller\millean02,PG,26,LAC,80,80,2913,377,928,0.406,23,108,0.213,354,820,0.432,0.419,311,391,0.795,84,232,316,537,99,11,206,203,1088
2002-2003,Brad Miller\millebr01,C,26,IND,73,72,2270,329,667,0.493,5,16,0.313,324,651,0.498,0.497,292,357,0.818,185,418,603,193,65,43,118,203,955
2002-2003,Mike Miller\millemi01,SF,22,TOT,65,52,2186,373,859,0.434,109,300,0.363,264,559,0.472,0.498,156,186,0.839,46,295,341,170,42,21,125,173,1011
2002-2003,Mike Miller\millemi01,SF,22,ORL,49,39,1826,296,708,0.418,87,256,0.34,209,452,0.462,0.48,127,150,0.847,40,246,286,139,36,16,99,139,806
2002-2003,Mike Miller\millemi01,SF,22,MEM,16,13,360,77,151,0.51,22,44,0.5,55,107,0.514,0.583,29,36,0.806,6,49,55,31,6,5,26,34,205
2002-2003,Reggie Miller*\millere01,SG,37,IND,70,70,2117,281,637,0.441,113,318,0.355,168,319,0.527,0.53,207,230,0.9,21,151,172,170,62,4,66,89,882
2002-2003,Chris Mills\millsch01,PF,33,GSW,21,0,262,39,106,0.368,7,25,0.28,32,81,0.395,0.401,16,18,0.889,19,31,50,22,7,3,10,29,101
2002-2003,Yao Ming*\mingya01,C,22,HOU,82,72,2382,401,805,0.498,1,2,0.5,400,803,0.498,0.499,301,371,0.811,196,479,675,137,31,147,173,230,1104
2002-2003,Cuttino Mobley\moblecu01,SG,27,HOU,73,73,3044,463,1067,0.434,112,318,0.352,351,749,0.469,0.486,242,282,0.858,70,233,303,208,95,36,166,185,1280
2002-2003,Nazr Mohammed\mohamna01,C,25,ATL,35,0,445,67,159,0.421,0,0,,67,159,0.421,0.421,26,41,0.634,47,82,129,6,16,21,25,79,160
2002-2003,Jerome Moiso\moisoje01,C,24,NOH,51,1,644,89,171,0.52,0,0,,89,171,0.52,0.52,27,41,0.659,59,119,178,22,19,44,46,87,205
2002-2003,Mikki Moore\mooremi01,C,27,TOT,8,0,43,5,13,0.385,0,0,,5,13,0.385,0.385,8,10,0.8,6,2,8,3,0,4,2,7,18
2002-2003,Mikki Moore\mooremi01,C,27,BOS,3,0,12,0,1,0,0,0,,0,1,0,0,0,0,,1,0,1,0,0,2,0,6,0
2002-2003,Mikki Moore\mooremi01,C,27,ATL,5,0,31,5,12,0.417,0,0,,5,12,0.417,0.417,8,10,0.8,5,2,7,3,0,2,2,1,18
2002-2003,Terence Morris\morrite01,SF,24,HOU,49,0,632,82,176,0.466,7,32,0.219,75,144,0.521,0.486,11,14,0.786,40,88,128,25,8,17,29,35,182
2002-2003,Troy Murphy\murphtr01,PF,22,GSW,79,79,2510,338,749,0.451,3,14,0.214,335,735,0.456,0.453,244,290,0.841,228,578,806,106,65,30,111,246,923
2002-2003,Ronald Murray\murraro01,SG,23,TOT,14,0,62,11,31,0.355,0,5,0,11,26,0.423,0.355,5,8,0.625,0,4,4,5,4,0,8,0,27
2002-2003,Ronald Murray\murraro01,SG,23,MIL,12,0,42,9,26,0.346,0,4,0,9,22,0.409,0.346,5,8,0.625,0,1,1,3,4,0,4,0,23
2002-2003,Ronald Murray\murraro01,SG,23,SEA,2,0,20,2,5,0.4,0,1,0,2,4,0.5,0.4,0,0,,0,3,3,2,0,0,4,0,4
2002-2003,Tracy Murray\murratr01,SF,31,LAL,31,0,193,23,71,0.324,8,38,0.211,15,33,0.455,0.38,7,9,0.778,5,18,23,12,5,3,14,22,61
2002-2003,Dikembe Mutombo*\mutomdi01,C,36,NJN,24,16,514,49,131,0.374,0,0,,49,131,0.374,0.374,40,55,0.727,54,99,153,19,4,37,34,54,138
2002-2003,Mamadou N'Diaye\ndiayma02,C,27,TOR,22,8,364,43,96,0.448,0,0,,43,96,0.448,0.448,34,47,0.723,29,53,82,7,8,32,21,58,120
2002-2003,Bostjan Nachbar\nachbbo01,SF,22,HOU,14,1,77,11,31,0.355,2,10,0.2,9,21,0.429,0.387,5,10,0.5,3,8,11,3,2,2,6,13,29
2002-2003,Lee Nailon\nailole01,SF,27,NYK,38,0,405,84,190,0.442,0,1,0,84,189,0.444,0.442,42,51,0.824,32,38,70,26,6,3,32,46,210
2002-2003,Eduardo Najera\najered01,SF,26,DAL,48,12,1103,129,231,0.558,0,1,0,129,230,0.561,0.558,62,91,0.681,90,133,223,47,40,22,23,129,320
2002-2003,Steve Nash\nashst01,PG,28,DAL,82,82,2711,518,1114,0.465,111,269,0.413,407,845,0.482,0.515,308,339,0.909,63,171,234,598,85,6,192,134,1455
2002-2003,Rasho Nesterovic\nestera01,C,26,MIN,77,77,2337,400,762,0.525,0,2,0,400,760,0.526,0.525,61,95,0.642,146,358,504,114,39,116,99,256,861
2002-2003,Ira Newble\newblir01,SF,28,ATL,73,45,1931,231,467,0.495,32,84,0.381,199,383,0.52,0.529,70,90,0.778,86,185,271,99,50,26,69,174,564
2002-2003,Moochie Norris\norrimo01,PG,29,HOU,82,3,1375,134,330,0.406,11,45,0.244,123,285,0.432,0.423,78,114,0.684,37,122,159,196,55,4,86,72,357
2002-2003,Dirk Nowitzki\nowitdi01,PF,24,DAL,80,80,3117,690,1489,0.463,148,390,0.379,542,1099,0.493,0.513,483,548,0.881,81,710,791,239,111,82,152,206,2011
2002-2003,Jermaine O'Neal\onealje01,PF,24,IND,77,76,2864,610,1260,0.484,7,21,0.333,603,1239,0.487,0.487,373,510,0.731,202,594,796,155,66,178,180,277,1600
2002-2003,Shaquille O'Neal*\onealsh01,C,30,LAL,67,66,2535,695,1211,0.574,0,0,,695,1211,0.574,0.574,451,725,0.622,259,483,742,206,38,159,196,229,1841
2002-2003,Charles Oakley\oaklech01,C,39,WAS,42,1,514,23,55,0.418,0,0,,23,55,0.418,0.418,28,34,0.824,37,70,107,40,13,6,21,90,74
2002-2003,Lamar Odom\odomla01,SF,23,LAC,49,47,1679,268,611,0.439,42,129,0.326,226,482,0.469,0.473,136,175,0.777,59,267,326,178,42,41,140,181,714
2002-2003,Mehmet Okur\okurme01,PF,23,DET,72,9,1366,180,423,0.426,38,112,0.339,142,311,0.457,0.47,96,131,0.733,117,218,335,71,25,39,66,167,494
2002-2003,Dean Oliver\olivede01,PG,24,GSW,15,0,93,7,29,0.241,1,6,0.167,6,23,0.261,0.259,7,8,0.875,8,8,16,23,7,0,10,9,22
2002-2003,Kevin Ollie\ollieke01,PG,30,TOT,82,5,1897,199,441,0.451,2,6,0.333,197,435,0.453,0.454,134,178,0.753,25,157,182,291,69,5,72,122,534
2002-2003,Kevin Ollie\ollieke01,PG,30,MIL,53,4,1127,117,255,0.459,1,5,0.2,116,250,0.464,0.461,68,91,0.747,12,87,99,181,37,4,36,71,303
2002-2003,Kevin Ollie\ollieke01,PG,30,SEA,29,1,770,82,186,0.441,1,1,1,81,185,0.438,0.444,66,87,0.759,13,70,83,110,32,1,36,51,231
2002-2003,Michael Olowokandi\olowomi01,C,27,LAC,36,36,1369,186,436,0.427,0,0,,186,436,0.427,0.427,69,105,0.657,57,271,328,47,18,79,98,110,441
2002-2003,Greg Ostertag\ostergr01,C,29,UTA,81,74,1926,169,326,0.518,0,0,,169,326,0.518,0.518,100,196,0.51,180,323,503,55,20,147,104,235,438
2002-2003,Bo Outlaw\outlabo01,C,31,PHO,80,20,1800,153,278,0.55,0,2,0,153,276,0.554,0.55,72,116,0.621,134,234,368,112,50,71,76,194,378
2002-2003,Chris Owens\owensch01,SF,23,MEM,1,0,6,2,3,0.667,0,0,,2,3,0.667,0.667,0,0,,1,0,1,0,0,0,1,0,4
2002-2003,Olumide Oyedeji\oyedeol01,C,21,ORL,27,3,145,10,23,0.435,0,0,,10,23,0.435,0.435,7,11,0.636,10,40,50,5,5,3,5,30,27
2002-2003,Robert Pack\packro01,PG,33,NOH,28,4,440,52,129,0.403,0,5,0,52,124,0.419,0.403,41,55,0.745,11,40,51,81,25,0,40,35,145
2002-2003,Scott Padgett\padgesc01,PF,26,UTA,82,2,1321,170,423,0.402,45,133,0.338,125,290,0.431,0.455,81,107,0.757,83,189,272,86,41,24,70,148,466
2002-2003,Milt Palacio\palacmi01,PG,24,CLE,80,46,1976,162,388,0.418,8,37,0.216,154,351,0.439,0.428,65,87,0.747,48,187,235,259,68,16,131,168,397
2002-2003,Jannero Pargo\pargoja01,PG,23,LAL,34,0,342,37,93,0.398,7,24,0.292,30,69,0.435,0.435,4,4,1,9,28,37,39,13,2,23,45,85
2002-2003,Smush Parker\parkesm01,PG,21,CLE,66,18,1103,136,338,0.402,38,118,0.322,98,220,0.445,0.459,98,118,0.831,29,90,119,162,48,12,133,106,408
2002-2003,Tony Parker\parketo01,PG,20,SAS,82,82,2774,484,1043,0.464,82,243,0.337,402,800,0.503,0.503,219,290,0.755,33,183,216,432,71,4,198,174,1269
2002-2003,Cherokee Parks\parksch02,PF,30,LAC,30,18,648,82,163,0.503,1,2,0.5,81,161,0.503,0.506,23,38,0.605,46,86,132,21,16,20,18,52,188
2002-2003,Ruben Patterson\patteru01,SF,27,POR,78,17,1655,254,516,0.492,3,20,0.15,251,496,0.506,0.495,138,220,0.627,120,144,264,101,73,29,117,161,649
2002-2003,Gary Payton*\paytoga01,PG,34,TOT,80,80,3208,665,1466,0.454,54,182,0.297,611,1284,0.476,0.472,250,352,0.71,79,255,334,663,133,20,187,181,1634
2002-2003,Gary Payton*\paytoga01,PG,34,SEA,52,52,2123,444,992,0.448,34,114,0.298,410,878,0.467,0.465,162,234,0.692,56,192,248,457,93,12,131,117,1084
2002-2003,Gary Payton*\paytoga01,PG,34,MIL,28,28,1085,221,474,0.466,20,68,0.294,201,406,0.495,0.487,88,118,0.746,23,63,86,206,40,8,56,64,550
2002-2003,Anthony Peeler\peelean01,SG,33,MIN,82,39,2245,252,609,0.414,87,212,0.41,165,397,0.416,0.485,39,50,0.78,40,201,241,244,72,13,82,161,630
2002-2003,Wesley Person\persowe01,SG,31,MEM,66,44,1941,274,601,0.456,100,231,0.433,174,370,0.47,0.539,79,97,0.814,24,168,192,112,42,19,56,64,727
2002-2003,Morris Peterson\petermo01,SF,25,TOR,82,80,2949,421,1073,0.392,116,344,0.337,305,729,0.418,0.446,195,247,0.789,97,266,363,188,88,32,128,232,1153
2002-2003,Eric Piatkowski\piatker01,SG,32,LAC,62,26,1360,210,446,0.471,80,201,0.398,130,245,0.531,0.561,101,122,0.828,44,112,156,70,33,9,56,92,601
2002-2003,Paul Pierce\piercpa01,SG,25,BOS,79,79,3096,663,1592,0.416,118,391,0.302,545,1201,0.454,0.454,604,753,0.802,106,472,578,349,139,62,288,227,2048
2002-2003,Scottie Pippen*\pippesc01,SF,37,POR,64,58,1911,265,597,0.444,38,133,0.286,227,464,0.489,0.476,121,148,0.818,57,221,278,285,105,25,164,149,689
2002-2003,Scot Pollard\pollasc01,C,27,SAC,23,0,325,40,87,0.46,0,0,,40,87,0.46,0.46,23,38,0.605,46,60,106,6,13,15,15,50,103
2002-2003,James Posey\poseyja01,SF,26,TOT,83,71,2518,309,752,0.411,70,229,0.306,239,523,0.457,0.457,205,246,0.833,90,336,426,184,106,15,144,197,893
2002-2003,James Posey\poseyja01,SF,26,DEN,25,24,872,121,324,0.373,24,88,0.273,97,236,0.411,0.41,86,102,0.843,38,107,145,78,29,6,66,63,352
2002-2003,James Posey\poseyja01,SF,26,HOU,58,47,1646,188,428,0.439,46,141,0.326,142,287,0.495,0.493,119,144,0.826,52,229,281,106,77,9,78,134,541
2002-2003,Lavor Postell\postela01,SG,24,NYK,12,0,98,14,38,0.368,2,7,0.286,12,31,0.387,0.395,13,15,0.867,1,3,4,3,2,0,7,9,43
2002-2003,Vitaly Potapenko\potapvi01,C,27,SEA,26,2,403,41,93,0.441,0,0,,41,93,0.441,0.441,22,29,0.759,25,64,89,4,9,8,25,46,104
2002-2003,Tayshaun Prince\princta01,SF,22,DET,42,5,435,53,118,0.449,20,47,0.426,33,71,0.465,0.534,11,17,0.647,5,40,45,24,10,14,21,25,137
2002-2003,Joel Przybilla\przybjo01,C,23,MIL,32,17,546,18,46,0.391,0,0,,18,46,0.391,0.391,12,24,0.5,48,97,145,12,10,45,19,85,48
2002-2003,Vladimir Radmanovic\radmavl01,PF,22,SEA,72,16,1910,274,668,0.41,104,293,0.355,170,375,0.453,0.488,72,102,0.706,76,247,323,97,64,22,100,136,724
2002-2003,Igor Rakocevic\rakocig01,PG,24,MIN,42,0,244,22,58,0.379,5,12,0.417,17,46,0.37,0.422,29,36,0.806,4,13,17,33,4,0,23,25,78
2002-2003,Zach Randolph\randoza01,PF,21,POR,77,11,1301,264,515,0.513,0,5,0,264,510,0.518,0.513,122,161,0.758,139,204,343,41,42,14,62,141,650
2002-2003,Theo Ratliff\ratlith01,C,29,ATL,81,81,2518,276,595,0.464,0,0,,276,595,0.464,0.464,154,214,0.72,154,453,607,73,56,262,137,271,706
2002-2003,Zeljko Rebraca\rebraze01,C,30,DET,30,12,488,80,145,0.552,0,0,,80,145,0.552,0.552,38,48,0.792,27,65,92,9,6,17,29,79,198
2002-2003,Michael Redd\reddmi01,SG,23,MIL,82,14,2316,455,971,0.469,182,416,0.438,273,555,0.492,0.562,149,185,0.805,98,273,371,117,100,13,74,143,1241
2002-2003,Don Reid\reiddo01,PF,29,DET,1,0,10,0,3,0,0,0,,0,3,0,0,1,2,0.5,0,0,0,0,0,0,0,4,1
2002-2003,Efthimi Rentzias\rentzef01,C,27,PHI,35,0,144,20,59,0.339,4,8,0.5,16,51,0.314,0.373,8,9,0.889,10,16,26,7,6,2,4,21,52
2002-2003,Glen Rice\ricegl01,SF,35,HOU,62,26,1532,196,457,0.429,101,254,0.398,95,203,0.468,0.539,63,83,0.759,28,126,154,65,23,5,55,99,556
2002-2003,Jason Richardson\richaja01,SG,22,GSW,82,82,2698,476,1161,0.41,123,334,0.368,353,827,0.427,0.463,207,271,0.764,111,267,378,247,90,23,179,201,1282
2002-2003,Quentin Richardson\richaqu01,SG,22,LAC,59,13,1368,203,546,0.372,61,198,0.308,142,348,0.408,0.428,85,124,0.685,98,183,281,52,35,10,64,92,552
2002-2003,Antoine Rigaudeau\rigauan01,SG,31,DAL,11,0,91,8,35,0.229,1,5,0.2,7,30,0.233,0.243,0,0,,4,4,8,6,3,0,6,11,17
2002-2003,Clifford Robinson\robincl02,PF,36,DET,81,69,2825,372,935,0.398,87,259,0.336,285,676,0.422,0.444,161,238,0.676,81,237,318,268,87,88,158,259,992
2002-2003,David Robinson*\robinda01,C,37,SAS,64,64,1676,197,420,0.469,0,0,,197,420,0.469,0.469,152,214,0.71,163,345,508,61,52,111,83,126,546
2002-2003,Eddie Robinson\robined01,SF,26,CHI,64,18,1355,155,315,0.492,3,14,0.214,152,301,0.505,0.497,51,63,0.81,76,124,200,66,62,13,52,120,364
2002-2003,Glenn Robinson\robingl01,SF,30,ATL,69,68,2591,539,1248,0.432,90,263,0.342,449,985,0.456,0.468,268,306,0.876,86,371,457,205,91,26,248,183,1436
2002-2003,Rodney Rogers\rogerro01,PF,31,NJN,68,0,1303,183,455,0.402,44,132,0.333,139,323,0.43,0.451,68,90,0.756,61,202,263,107,50,31,91,192,478
2002-2003,Sean Rooks\rooksse01,C,33,LAC,70,38,1344,125,297,0.421,0,1,0,125,296,0.422,0.421,47,58,0.81,53,163,216,69,34,44,66,174,297
2002-2003,Jalen Rose\roseja01,SF,30,CHI,82,82,3351,642,1583,0.406,133,359,0.37,509,1224,0.416,0.448,399,467,0.854,68,283,351,395,72,23,285,271,1816
2002-2003,Malik Rose\rosema01,PF,28,SAS,79,13,1933,289,630,0.459,2,5,0.4,287,625,0.459,0.46,242,306,0.791,148,358,506,124,57,40,170,206,822
2002-2003,Guy Rucker\ruckegu01,PF,25,GSW,3,0,4,0,0,,0,0,,0,0,,,0,0,,0,1,1,1,0,0,0,1,0
2002-2003,Kareem Rush\rushka01,PG,22,LAL,76,0,872,96,244,0.393,19,68,0.279,77,176,0.438,0.432,16,23,0.696,26,68,94,68,10,11,63,71,227
2002-2003,Bryon Russell\russebr01,SF,32,WAS,70,23,1388,108,306,0.353,46,140,0.329,62,166,0.373,0.428,53,69,0.768,43,165,208,72,70,7,55,130,315
2002-2003,Arvydas Sabonis*\sabonar01,C,38,POR,78,1,1209,172,361,0.476,3,6,0.5,169,355,0.476,0.481,129,164,0.787,88,247,335,142,61,49,75,141,476
2002-2003,John Salmons\salmojo01,PG,23,PHI,64,1,504,48,116,0.414,10,31,0.323,38,85,0.447,0.457,26,35,0.743,16,43,59,47,17,6,29,53,132
2002-2003,Soumaila Samake\samakso01,C,24,LAL,13,1,77,10,24,0.417,0,0,,10,24,0.417,0.417,2,2,1,10,13,23,4,0,5,2,13,22
2002-2003,Jamal Sampson\sampsja01,PF,19,MIL,5,0,8,0,2,0,0,0,,0,2,0,0,0,0,,1,1,2,1,1,0,0,0,0
2002-2003,Pepe Sanchez\sanchpe01,PG,25,DET,9,0,37,0,5,0,0,0,,0,5,0,0,0,0,,4,2,6,8,5,0,2,3,0
2002-2003,Jeryl Sasser\sasseje01,SG,23,ORL,75,4,1025,64,207,0.309,13,44,0.295,51,163,0.313,0.341,53,78,0.679,64,120,184,65,45,12,39,91,194
2002-2003,Kenny Satterfield\satteke01,PG,21,TOT,39,6,502,55,183,0.301,5,28,0.179,50,155,0.323,0.314,17,25,0.68,16,27,43,68,20,2,43,36,132
2002-2003,Kenny Satterfield\satteke01,PG,21,DEN,22,6,420,51,165,0.309,5,28,0.179,46,137,0.336,0.324,16,23,0.696,12,23,35,53,18,2,36,30,123
2002-2003,Kenny Satterfield\satteke01,PG,21,PHI,17,0,82,4,18,0.222,0,0,,4,18,0.222,0.222,1,2,0.5,4,4,8,15,2,0,7,6,9
2002-2003,Predrag Savovic\savovpr01,SG,26,DEN,27,0,256,29,93,0.312,4,26,0.154,25,67,0.373,0.333,21,29,0.724,9,16,25,22,14,1,21,33,83
2002-2003,Brian Scalabrine\scalabr01,PF,24,NJN,59,7,724,68,169,0.402,14,39,0.359,54,130,0.415,0.444,30,36,0.833,40,101,141,46,16,18,46,77,180
2002-2003,Ansu Sesay\sesayan01,SF,26,SEA,45,4,448,41,107,0.383,0,0,,41,107,0.383,0.383,12,21,0.571,34,39,73,23,14,5,25,62,94
2002-2003,Brian Shaw\shawbr01,PG,36,LAL,72,0,900,101,261,0.387,38,109,0.349,63,152,0.414,0.46,10,15,0.667,20,99,119,103,32,13,54,62,250
2002-2003,Paul Shirley\shirlpa01,PF,25,ATL,2,0,5,0,4,0,0,0,,0,4,0,0,0,0,,0,1,1,0,0,0,0,0,0
2002-2003,Bobby Simmons\simmobo01,SG,22,WAS,36,2,378,44,112,0.393,0,5,0,44,107,0.411,0.393,32,35,0.914,33,44,77,20,10,3,8,51,120
2002-2003,Brian Skinner\skinnbr01,PF,26,PHI,77,9,1381,182,331,0.55,0,0,,182,331,0.55,0.55,97,161,0.602,136,230,366,19,47,53,62,176,461
2002-2003,Reggie Slater\slatere01,PF,32,MIN,26,0,141,27,50,0.54,0,0,,27,50,0.54,0.54,27,45,0.6,18,13,31,4,6,1,9,31,81
2002-2003,Tamar Slay\slayta01,SG,22,NJN,36,0,274,39,103,0.379,7,25,0.28,32,78,0.41,0.413,7,10,0.7,8,23,31,14,14,3,20,31,92
2002-2003,Charles Smith\smithch04,SG,27,POR,3,0,13,1,4,0.25,0,1,0,1,3,0.333,0.25,3,4,0.75,0,0,0,1,1,0,1,3,5
2002-2003,Joe Smith\smithjo02,SF,27,MIN,54,21,1117,151,328,0.46,0,2,0,151,326,0.463,0.46,102,131,0.779,111,159,270,38,14,55,43,171,404
2002-2003,Steve Smith\smithst01,SG,33,SAS,53,18,1032,113,291,0.388,39,118,0.331,74,173,0.428,0.455,95,114,0.833,21,78,99,70,28,9,43,79,360
2002-2003,Eric Snow\snower01,PG,29,PHI,82,82,3108,361,799,0.452,7,32,0.219,354,767,0.462,0.456,325,379,0.858,71,230,301,544,133,11,194,235,1054
2002-2003,Latrell Sprewell\sprewla01,SF,32,NYK,74,73,2859,454,1127,0.403,134,360,0.372,320,767,0.417,0.462,173,218,0.794,45,240,285,332,102,22,172,134,1215
2002-2003,Jerry Stackhouse\stackje01,SG,28,WAS,70,70,2747,491,1201,0.409,71,245,0.29,420,956,0.439,0.438,455,518,0.878,61,197,258,316,65,28,193,130,1508
2002-2003,Vladimir Stepania\stepavl01,C,26,MIA,79,6,1594,185,427,0.433,0,0,,185,427,0.433,0.433,71,134,0.53,211,343,554,24,45,40,69,169,441
2002-2003,DeShawn Stevenson\stevede01,SG,21,UTA,61,8,760,114,284,0.401,4,12,0.333,110,272,0.404,0.408,47,68,0.691,22,63,85,40,22,8,49,57,279
2002-2003,Michael Stewart\stewami01,PF,27,CLE,47,0,251,14,37,0.378,0,0,,14,37,0.378,0.378,8,12,0.667,19,36,55,6,2,15,10,42,36
2002-2003,John Stockton*\stockjo01,PG,40,UTA,82,82,2275,309,640,0.483,29,80,0.363,280,560,0.5,0.505,237,287,0.826,51,150,201,629,137,16,182,184,884
2002-2003,Peja Stojakovic\stojape01,SF,25,SAC,72,72,2450,497,1034,0.481,155,406,0.382,342,628,0.545,0.556,231,264,0.875,61,336,397,141,72,5,101,143,1380
2002-2003,Damon Stoudamire\stoudda01,PG,29,POR,59,27,1315,156,415,0.376,44,114,0.386,112,301,0.372,0.429,53,67,0.791,40,115,155,204,39,6,82,67,409
2002-2003,Amar'e Stoudemire\stoudam01,PF,20,PHO,82,71,2570,392,830,0.472,2,10,0.2,390,820,0.476,0.473,320,484,0.661,250,471,721,78,62,87,189,269,1106
2002-2003,Erick Strickland\stricer01,SG,29,IND,71,10,1275,163,380,0.429,62,160,0.388,101,220,0.459,0.511,70,87,0.805,23,122,145,209,38,7,98,111,458
2002-2003,Mark Strickland\stricma01,SF,32,DAL,4,0,13,2,5,0.4,0,0,,2,5,0.4,0.4,0,0,,5,2,7,0,0,0,1,1,4
2002-2003,Rod Strickland\stricro02,PG,36,MIN,47,8,956,120,278,0.432,1,11,0.091,119,267,0.446,0.433,79,107,0.738,20,75,95,215,46,6,76,55,320
2002-2003,Bruno Sundov\sundobr01,C,22,BOS,26,0,138,14,56,0.25,4,16,0.25,10,40,0.25,0.286,0,2,0,8,20,28,7,6,3,9,24,32
2002-2003,Bob Sura\surabo01,SG,29,GSW,55,0,1130,135,328,0.412,28,85,0.329,107,243,0.44,0.454,103,148,0.696,58,109,167,177,45,2,82,108,401
2002-2003,Stromile Swift\swiftst01,PF,23,MEM,67,26,1478,235,489,0.481,0,2,0,235,487,0.483,0.481,177,245,0.722,114,270,384,45,55,104,99,152,647
2002-2003,Wally Szczerbiak\szczewa02,SF,25,MIN,52,42,1836,351,729,0.481,61,145,0.421,290,584,0.497,0.523,150,173,0.867,53,188,241,136,44,22,87,123,913
2002-2003,Maurice Taylor\tayloma01,PF,26,HOU,67,9,1377,231,535,0.432,0,2,0,231,533,0.433,0.432,100,138,0.725,95,143,238,66,22,22,100,151,562
2002-2003,Jason Terry\terryja01,PG,25,ATL,81,81,3081,488,1141,0.428,160,431,0.371,328,710,0.462,0.498,259,292,0.887,37,242,279,600,126,14,249,175,1395
2002-2003,Etan Thomas\thomaet01,PF,24,WAS,38,0,513,61,124,0.492,0,0,,61,124,0.492,0.492,60,94,0.638,70,95,165,3,8,23,33,66,182
2002-2003,Kenny Thomas\thomake01,PF,25,TOT,66,42,1978,260,559,0.465,0,0,,260,559,0.465,0.465,147,197,0.746,185,344,529,112,62,28,116,169,667
2002-2003,Kenny Thomas\thomake01,PF,25,HOU,20,14,586,82,190,0.432,0,0,,82,190,0.432,0.432,33,45,0.733,45,92,137,39,16,6,40,49,197
2002-2003,Kenny Thomas\thomake01,PF,25,PHI,46,28,1392,178,369,0.482,0,0,,178,369,0.482,0.482,114,152,0.75,140,252,392,73,46,22,76,120,470
2002-2003,Kurt Thomas\thomaku01,C,30,NYK,81,81,2577,497,1028,0.483,2,3,0.667,495,1025,0.483,0.484,138,184,0.75,160,477,637,162,81,97,138,344,1134
2002-2003,Tim Thomas\thomati01,SF,25,MIL,80,70,2358,412,930,0.443,97,265,0.366,315,665,0.474,0.495,145,186,0.78,97,292,389,102,70,49,133,257,1066
2002-2003,Jamaal Tinsley\tinslja01,PG,24,IND,73,69,2237,220,556,0.396,46,166,0.277,174,390,0.446,0.437,80,112,0.714,58,202,260,548,125,18,192,201,566
2002-2003,Oscar Torres\torreos01,SG,26,GSW,17,0,109,16,36,0.444,7,13,0.538,9,23,0.391,0.542,14,20,0.7,3,9,12,3,4,2,8,9,53
2002-2003,Robert Traylor\traylro01,C,25,NOH,69,0,851,105,237,0.443,1,3,0.333,104,234,0.444,0.445,57,88,0.648,108,154,262,50,45,37,53,153,268
2002-2003,Gary Trent\trentga01,SF,28,MIN,80,22,1222,208,389,0.535,0,2,0,208,387,0.537,0.535,60,101,0.594,106,185,291,77,32,23,59,142,476
2002-2003,Jeff Trepagnier\trepaje01,SG,23,DEN,8,0,97,17,40,0.425,4,8,0.5,13,32,0.406,0.475,7,7,1,8,8,16,6,8,0,8,5,45
2002-2003,Cezary Trybanski\trybace01,C,23,MEM,15,0,86,5,20,0.25,0,0,,5,20,0.25,0.25,4,10,0.4,6,8,14,1,0,6,8,13,14
2002-2003,Jake Tsakalidis\tsakaja01,C,23,PHO,33,27,543,61,135,0.452,0,0,,61,135,0.452,0.452,39,58,0.672,45,77,122,13,6,17,26,80,161
2002-2003,Nikoloz Tskitishvili\tskitni01,SF,19,DEN,81,16,1320,115,393,0.293,37,152,0.243,78,241,0.324,0.34,48,65,0.738,64,117,181,91,31,29,84,136,315
2002-2003,Hedo Turkoglu\turkohe01,SF,23,SAC,67,11,1175,165,391,0.422,29,78,0.372,136,313,0.435,0.459,88,110,0.8,35,153,188,87,25,12,50,125,447
2002-2003,Nick Van Exel\vanexni01,SG,31,DAL,73,1,2026,342,831,0.412,118,312,0.378,224,519,0.432,0.483,110,144,0.764,35,173,208,312,42,4,123,86,912
2002-2003,Keith Van Horn\vanhoke01,PF,27,PHI,74,73,2337,459,952,0.482,65,176,0.369,394,776,0.508,0.516,193,240,0.804,159,365,524,93,63,30,150,251,1176
2002-2003,Jacque Vaughn\vaughja01,PG,27,ORL,80,48,1686,184,411,0.448,8,34,0.235,176,377,0.467,0.457,97,125,0.776,26,92,118,232,64,2,97,169,473
2002-2003,Jake Voskuhl\voskuja01,C,25,PHO,65,1,947,92,163,0.564,0,0,,92,163,0.564,0.564,64,96,0.667,97,128,225,36,18,29,48,172,248
2002-2003,Dajuan Wagner\wagneda02,SG,19,CLE,47,24,1385,223,605,0.369,55,174,0.316,168,431,0.39,0.414,128,160,0.8,20,62,82,130,38,7,85,107,629
2002-2003,Antoine Walker\walkean02,PF,26,BOS,78,78,3235,603,1554,0.388,188,582,0.323,415,972,0.427,0.449,176,286,0.615,99,464,563,373,116,31,260,221,1570
2002-2003,Samaki Walker\walkesa01,C,26,LAL,67,39,1243,115,274,0.42,0,1,0,115,273,0.421,0.42,66,101,0.653,115,253,368,64,20,55,56,143,296
2002-2003,Ben Wallace\wallabe01,C,28,DET,73,73,2873,210,437,0.481,1,6,0.167,209,431,0.485,0.482,85,189,0.45,293,833,1126,120,104,230,88,179,506
2002-2003,Gerald Wallace\wallage01,SF,20,SAC,47,7,571,90,183,0.492,1,4,0.25,89,179,0.497,0.495,39,74,0.527,38,90,128,23,24,15,44,68,220
2002-2003,Rasheed Wallace\wallara01,PF,28,POR,74,74,2684,515,1094,0.471,110,307,0.358,405,787,0.515,0.521,200,272,0.735,113,435,548,153,70,77,140,223,1340
2002-2003,Charlie Ward\wardch01,PG,32,NYK,66,6,1465,165,414,0.399,101,267,0.378,64,147,0.435,0.521,41,53,0.774,25,152,177,306,78,11,95,146,472
2002-2003,Earl Watson\watsoea01,PG,23,MEM,79,2,1366,170,391,0.435,31,91,0.341,139,300,0.463,0.474,62,86,0.721,46,118,164,225,89,14,88,138,433
2002-2003,Clarence Weatherspoon\weathcl01,PF,32,NYK,79,19,2024,186,414,0.449,0,0,,186,414,0.449,0.449,149,194,0.768,214,385,599,68,69,36,63,174,521
2002-2003,Chris Webber\webbech01,PF,29,SAC,67,67,2622,661,1433,0.461,5,21,0.238,656,1412,0.465,0.463,215,354,0.607,160,544,704,364,106,88,215,204,1542
2002-2003,Bonzi Wells\wellsbo01,SG,26,POR,75,65,2396,437,990,0.441,38,130,0.292,399,860,0.464,0.461,226,313,0.722,98,296,394,246,123,18,215,220,1138
2002-2003,Jiri Welsch\welscji01,SF,23,GSW,37,0,234,19,75,0.253,1,4,0.25,18,71,0.254,0.26,22,29,0.759,12,16,28,27,8,2,19,32,61
2002-2003,David Wesley\wesleda01,SG,32,NOH,73,73,2710,449,1037,0.433,134,316,0.424,315,721,0.437,0.498,185,237,0.781,38,137,175,251,109,9,132,173,1217
2002-2003,Jahidi White\whiteja01,C,26,WAS,16,8,230,25,53,0.472,0,0,,25,53,0.472,0.472,17,25,0.68,37,36,73,2,1,12,9,33,67
2002-2003,Rodney White\whitero02,SG,22,DEN,72,19,1563,260,638,0.408,32,134,0.239,228,504,0.452,0.433,98,125,0.784,43,170,213,121,45,32,156,134,650
2002-2003,Chris Whitney\whitnch01,PG,31,TOT,51,21,1052,124,349,0.355,50,164,0.305,74,185,0.4,0.427,57,69,0.826,3,64,67,145,29,2,71,92,355
2002-2003,Chris Whitney\whitnch01,PG,31,DEN,29,20,762,94,261,0.36,43,128,0.336,51,133,0.383,0.443,46,57,0.807,1,45,46,124,17,1,55,77,277
2002-2003,Chris Whitney\whitnch01,PG,31,ORL,22,1,290,30,88,0.341,7,36,0.194,23,52,0.442,0.381,11,12,0.917,2,19,21,21,12,1,16,15,78
2002-2003,Chris Wilcox\wilcoch01,PF,20,LAC,46,3,479,73,140,0.521,0,0,,73,140,0.521,0.521,25,50,0.5,32,72,104,21,7,12,26,65,171
2002-2003,Mike Wilks\wilksmi01,PG-SG,23,TOT,46,7,688,50,148,0.338,10,35,0.286,40,113,0.354,0.372,37,47,0.787,20,51,71,92,27,4,28,69,147
2002-2003,Mike Wilks\wilksmi01,SG,23,ATL,15,7,364,29,81,0.358,6,17,0.353,23,64,0.359,0.395,21,29,0.724,9,32,41,42,16,1,16,38,85
2002-2003,Mike Wilks\wilksmi01,PG,23,MIN,31,0,324,21,67,0.313,4,18,0.222,17,49,0.347,0.343,16,18,0.889,11,19,30,50,11,3,12,31,62
2002-2003,Aaron Williams\williaa01,C,31,NJN,81,0,1597,199,439,0.453,0,1,0,199,438,0.454,0.453,102,130,0.785,137,194,331,88,27,57,85,206,500
2002-2003,Alvin Williams\willial02,PG,28,TOR,78,78,2638,396,905,0.438,48,146,0.329,348,759,0.458,0.464,187,239,0.782,55,190,245,416,111,21,128,170,1027
2002-2003,Brandon Williams\willibr01,SF,27,ATL,6,0,19,1,7,0.143,0,1,0,1,6,0.167,0.143,0,0,,2,0,2,0,2,0,3,4,2
2002-2003,Eric Williams\willier01,SF,30,BOS,82,79,2350,254,575,0.442,37,110,0.336,217,465,0.467,0.474,201,268,0.75,143,239,382,140,86,19,97,234,746
2002-2003,Frank Williams\willifr02,PG,22,NYK,21,0,167,9,33,0.273,6,16,0.375,3,17,0.176,0.364,4,6,0.667,3,15,18,34,7,2,17,20,28
2002-2003,Jason Williams\willija02,PG,27,MEM,76,76,2407,333,859,0.388,143,404,0.354,190,455,0.418,0.471,110,131,0.84,25,187,212,631,91,10,168,130,919
2002-2003,Jay Williams\willija03,PG,21,CHI,75,54,1961,273,685,0.399,65,202,0.322,208,483,0.431,0.446,103,161,0.64,27,168,195,350,86,17,171,179,714
2002-2003,Jerome Williams\willije01,PF,29,TOR,71,63,2346,267,535,0.499,1,6,0.167,266,529,0.503,0.5,156,281,0.555,231,419,650,95,116,26,98,197,691
2002-2003,Monty Williams\willimo01,SF,31,PHI,21,2,276,34,80,0.425,0,2,0,34,78,0.436,0.425,24,32,0.75,12,33,45,26,12,5,17,33,92
2002-2003,Scott Williams\willisc01,C,34,PHO,69,33,872,120,292,0.411,0,2,0,120,290,0.414,0.411,33,42,0.786,72,121,193,22,27,21,32,159,273
2002-2003,Shammond Williams\willish01,PG,27,TOT,78,11,1881,228,579,0.394,93,261,0.356,135,318,0.425,0.474,78,102,0.765,24,147,171,266,77,6,114,140,627
2002-2003,Shammond Williams\willish01,PG,27,BOS,51,2,1169,134,338,0.396,56,159,0.352,78,179,0.436,0.479,48,57,0.842,12,98,110,128,61,3,61,84,372
2002-2003,Shammond Williams\willish01,PG,27,DEN,27,9,712,94,241,0.39,37,102,0.363,57,139,0.41,0.467,30,45,0.667,12,49,61,138,16,3,53,56,255
2002-2003,Walt Williams\williwa02,SF,32,DAL,66,1,1161,134,341,0.393,64,171,0.374,70,170,0.412,0.487,31,50,0.62,53,154,207,59,42,26,35,141,363
2002-2003,Corliss Williamson\willico02,SF,29,DET,82,1,2061,374,826,0.453,2,11,0.182,372,815,0.456,0.454,237,300,0.79,147,211,358,104,44,27,126,238,987
2002-2003,Kevin Willis\willike02,C,40,SAS,71,6,840,123,257,0.479,0,2,0,123,255,0.482,0.479,51,83,0.614,83,143,226,24,20,20,60,120,297
2002-2003,Ruben Wolkowyski\wolkoru01,PF,29,BOS,7,0,24,2,4,0.5,0,1,0,2,3,0.667,0.5,1,4,0.25,0,1,1,1,0,0,1,3,5
2002-2003,Loren Woods\woodslo01,C,24,MIN,38,11,353,29,76,0.382,1,3,0.333,28,73,0.384,0.388,21,27,0.778,27,68,95,19,10,13,23,37,80
2002-2003,Qyntel Woods\woodsqy01,PF,21,POR,53,0,334,59,118,0.5,3,9,0.333,56,109,0.514,0.513,7,20,0.35,15,38,53,12,15,1,23,36,128
2002-2003,Metta World Peace\artesro01,SF,23,IND,69,67,2317,362,846,0.428,71,211,0.336,291,635,0.458,0.47,273,371,0.736,101,261,362,198,159,50,145,242,1068
2002-2003,Lorenzen Wright\wrighlo02,C,27,MEM,70,49,1982,325,716,0.454,0,5,0,325,711,0.457,0.454,147,223,0.659,170,358,528,80,51,54,110,209,797
2002-2003,Vincent Yarbrough\yarbrvi01,SG,21,DEN,59,39,1381,168,428,0.393,21,78,0.269,147,350,0.42,0.417,49,62,0.79,36,126,162,130,57,33,81,145,406
2002-2003,Wang Zhizhi\zhizhwa01,C,25,LAC,41,1,412,62,162,0.383,16,47,0.34,46,115,0.4,0.432,42,58,0.724,26,51,77,10,8,10,31,41,182Season,Player,Pos,Age,Tm,G,GS,MP,FG,FGA,FG%,3P,3PA,3P%,2P,2PA,2P%,eFG%,FT,FTA,FT%,ORB,DRB,TRB,AST,STL,BLK,TOV,PF,PTS
2000-2001,Mahmoud Abdul-Rauf\abdulma02,PG,31,VAN,41,0,486,120,246,0.488,4,14,0.286,116,232,0.5,0.496,22,29,0.759,5,20,25,76,9,1,26,50,266
2000-2001,Tariq Abdul-Wahad\abdulta01,SG,26,DEN,29,12,420,43,111,0.387,4,10,0.4,39,101,0.386,0.405,21,36,0.583,14,45,59,22,14,13,34,54,111
2000-2001,Shareef Abdur-Rahim\abdursh01,SF,24,VAN,81,81,3241,604,1280,0.472,12,64,0.188,592,1216,0.487,0.477,443,531,0.834,175,560,735,250,90,77,231,238,1663
2000-2001,Cory Alexander\alexaco01,PG,27,ORL,26,0,227,18,56,0.321,4,16,0.25,14,40,0.35,0.357,12,18,0.667,0,25,25,36,16,0,25,29,52
2000-2001,Courtney Alexander\alexaco02,PG,23,TOT,65,24,1382,239,573,0.417,17,46,0.37,222,527,0.421,0.432,123,150,0.82,42,101,143,62,45,5,75,139,618
2000-2001,Courtney Alexander\alexaco02,PG,23,DAL,38,6,472,62,178,0.348,3,10,0.3,59,168,0.351,0.357,33,45,0.733,20,43,63,21,16,3,21,76,160
2000-2001,Courtney Alexander\alexaco02,PG,23,WAS,27,18,910,177,395,0.448,14,36,0.389,163,359,0.454,0.466,90,105,0.857,22,58,80,41,29,2,54,63,458
2000-2001,Ray Allen\allenra02,SG,25,MIL,82,82,3129,628,1309,0.48,202,467,0.433,426,842,0.506,0.557,348,392,0.888,101,327,428,374,124,20,204,192,1806
2000-2001,Rafer Alston\alstora01,PG,24,MIL,37,2,288,30,84,0.357,8,30,0.267,22,54,0.407,0.405,9,13,0.692,4,27,31,68,13,0,20,27,77
2000-2001,John Amaechi\amaecjo01,C,30,ORL,82,36,1710,237,592,0.4,0,7,0,237,585,0.405,0.4,176,279,0.631,77,191,268,74,28,29,124,175,650
2000-2001,Derek Anderson\anderde01,SG,26,SAS,82,82,2859,413,993,0.416,101,253,0.399,312,740,0.422,0.467,342,402,0.851,75,288,363,301,120,14,165,188,1269
2000-2001,Kenny Anderson\anderke01,PG,30,BOS,33,28,849,88,227,0.388,11,33,0.333,77,194,0.397,0.412,59,71,0.831,16,57,73,134,44,2,52,62,246
2000-2001,Nick Anderson\anderni01,SG,33,SAC,21,0,169,14,57,0.246,10,39,0.256,4,18,0.222,0.333,0,0,,3,22,25,13,10,4,7,13,38
2000-2001,Shandon Anderson\andersh01,SG,27,HOU,82,82,2396,263,590,0.446,46,170,0.271,217,420,0.517,0.485,138,188,0.734,72,261,333,189,82,40,131,202,710
2000-2001,Greg Anthony\anthogr01,PG,33,POR,58,0,856,97,253,0.383,65,159,0.409,32,94,0.34,0.512,23,35,0.657,21,40,61,82,40,3,43,63,282
2000-2001,Darrell Armstrong\armstda01,PG,32,ORL,75,75,2767,413,1002,0.412,143,403,0.355,270,599,0.451,0.484,220,249,0.884,94,249,343,524,135,13,200,155,1189
2000-2001,Chucky Atkins\atkinch01,PG,26,DET,81,75,2363,380,952,0.399,121,339,0.357,259,613,0.423,0.463,90,130,0.692,28,145,173,330,67,5,149,184,971
2000-2001,Stacey Augmon\augmost01,SG,32,POR,66,23,1182,127,266,0.477,0,4,0,127,262,0.485,0.477,57,87,0.655,60,99,159,98,48,21,48,105,311
2000-2001,Isaac Austin\austiis01,C,31,VAN,52,16,845,96,270,0.356,6,24,0.25,90,246,0.366,0.367,28,40,0.7,50,172,222,58,20,23,54,94,226
2000-2001,William Avery\averywi01,PG,21,MIN,55,0,463,55,144,0.382,16,59,0.271,39,85,0.459,0.438,28,36,0.778,5,24,29,75,13,4,45,48,154
2000-2001,Dalibor Bagaric\bagarda01,C,20,CHI,35,0,259,17,65,0.262,0,1,0,17,64,0.266,0.262,13,28,0.464,22,34,56,10,9,16,21,44,47
2000-2001,Vin Baker\bakervi01,PF,29,SEA,76,27,2129,347,822,0.422,1,16,0.063,346,806,0.429,0.423,232,321,0.723,179,251,430,90,38,73,158,264,927
2000-2001,Erick Barkley\barkler01,PG,22,POR,8,0,38,8,22,0.364,3,8,0.375,5,14,0.357,0.432,0,0,,0,3,3,6,2,0,5,2,19
2000-2001,Dana Barros\barroda01,PG,33,DET,60,0,1079,183,412,0.444,44,105,0.419,139,307,0.453,0.498,68,80,0.85,6,88,94,110,30,2,60,63,478
2000-2001,Brent Barry\barrybr01,SG,29,SEA,67,20,1778,198,401,0.494,109,229,0.476,89,172,0.517,0.63,84,103,0.816,33,178,211,225,80,14,86,126,589
2000-2001,Jon Barry\barryjo01,SG,31,SAC,62,2,1010,103,255,0.404,46,132,0.348,57,123,0.463,0.494,64,73,0.877,16,78,94,130,28,6,53,66,316
2000-2001,Tony Battie\battito01,C,24,BOS,40,25,845,108,201,0.537,0,3,0,108,198,0.545,0.537,44,69,0.638,73,160,233,16,27,60,37,126,260
2000-2001,Raja Bell\bellra01,SG,24,PHI,5,0,30,2,7,0.286,1,3,0.333,1,4,0.25,0.357,0,0,,0,1,1,0,1,0,2,1,5
2000-2001,Jonathan Bender\bendejo01,SF,20,IND,59,7,574,66,186,0.355,11,41,0.268,55,145,0.379,0.384,50,68,0.735,14,60,74,32,7,28,42,73,193
2000-2001,Corey Benjamin\benjaco01,PG,22,CHI,65,5,857,115,302,0.381,21,81,0.259,94,221,0.425,0.416,56,83,0.675,38,62,100,69,28,16,63,128,307
2000-2001,David Benoit\benoida01,SF,32,UTA,49,2,446,71,147,0.483,5,13,0.385,66,134,0.493,0.5,31,39,0.795,20,61,81,22,6,6,28,75,178
2000-2001,Travis Best\besttr01,PG,28,IND,77,21,2457,347,788,0.44,37,97,0.381,310,691,0.449,0.464,187,226,0.827,38,184,222,473,110,11,127,246,918
2000-2001,Mike Bibby\bibbymi01,PG,22,VAN,82,82,3190,525,1157,0.454,108,285,0.379,417,872,0.478,0.5,143,188,0.761,47,257,304,685,107,12,248,148,1301
2000-2001,Chauncey Billups\billuch01,SG,24,MIN,77,33,1790,248,587,0.422,73,194,0.376,175,393,0.445,0.485,144,171,0.842,32,126,158,260,51,11,111,178,713
2000-2001,Mookie Blaylock\blaylmo01,PG,33,GSW,69,59,2352,317,801,0.396,73,225,0.324,244,576,0.424,0.441,53,76,0.697,71,201,272,462,163,20,128,134,760
2000-2001,Corie Blount\blounco01,PF,32,TOT,68,6,1305,130,294,0.442,2,8,0.25,128,286,0.448,0.446,51,83,0.614,181,219,400,59,42,22,73,165,313
2000-2001,Corie Blount\blounco01,PF,32,PHO,30,6,387,23,47,0.489,0,0,,23,47,0.489,0.489,8,15,0.533,35,50,85,8,13,5,18,75,54
2000-2001,Corie Blount\blounco01,PF,32,GSW,38,0,918,107,247,0.433,2,8,0.25,105,239,0.439,0.437,43,68,0.632,146,169,315,51,29,17,55,90,259
2000-2001,Mark Blount\blounma01,C,25,BOS,64,50,1098,101,200,0.505,0,0,,101,200,0.505,0.505,46,66,0.697,97,134,231,32,39,76,62,183,248
2000-2001,Muggsy Bogues\boguemu01,PG,36,TOR,3,0,34,0,2,0,0,1,0,0,1,0,0,0,0,,0,3,3,5,2,0,4,3,0
2000-2001,Etdrick Bohannon\bohanet01,PF,27,CLE,6,0,19,2,4,0.5,0,0,,2,4,0.5,0.5,4,4,1,3,4,7,0,0,2,1,4,8
2000-2001,Calvin Booth\boothca01,C,24,TOT,55,29,933,120,252,0.476,0,0,,120,252,0.476,0.476,53,78,0.679,77,169,246,42,29,111,53,146,293
2000-2001,Calvin Booth\boothca01,C,24,WAS,40,22,640,74,168,0.44,0,0,,74,168,0.44,0.44,33,45,0.733,53,121,174,23,17,81,36,91,181
2000-2001,Calvin Booth\boothca01,C,24,DAL,15,7,293,46,84,0.548,0,0,,46,84,0.548,0.548,20,33,0.606,24,48,72,19,12,30,17,55,112
2000-2001,Cal Bowdler\bowdlca01,SF,23,ATL,44,0,375,53,114,0.465,1,5,0.2,52,109,0.477,0.469,33,40,0.825,30,47,77,4,10,21,11,45,140
2000-2001,Bruce Bowen\bowenbr01,SF,29,MIA,82,72,2685,211,581,0.363,103,307,0.336,108,274,0.394,0.452,98,161,0.609,45,200,245,132,83,53,74,269,623
2000-2001,Ryan Bowen\bowenry01,SF,25,DEN,57,0,696,80,144,0.556,4,11,0.364,76,133,0.571,0.569,27,44,0.614,62,51,113,30,37,12,24,95,191
2000-2001,Ira Bowman\bowmair01,PG,27,ATL,3,0,19,0,2,0,0,0,,0,2,0,0,0,0,,1,1,2,7,0,0,1,0,0
2000-2001,Earl Boykins\boykiea01,PG,24,LAC,10,0,149,25,63,0.397,1,8,0.125,24,55,0.436,0.405,14,17,0.824,4,7,11,32,5,0,9,9,65
2000-2001,Shawn Bradley\bradlsh01,C,28,DAL,82,35,2001,219,447,0.49,1,6,0.167,218,441,0.494,0.491,140,178,0.787,160,448,608,38,36,228,88,256,579
2000-2001,Elton Brand\brandel01,PF,21,CHI,74,74,2906,578,1215,0.476,0,2,0,578,1213,0.477,0.476,334,472,0.708,285,461,746,240,71,118,219,243,1490
2000-2001,Terrell Brandon\brandte01,PG,30,MIN,78,78,2821,511,1134,0.451,33,91,0.363,478,1043,0.458,0.465,195,224,0.871,60,238,298,583,161,21,155,138,1250
2000-2001,Chucky Brown\brownch01,SF,32,TOT,26,2,339,40,95,0.421,0,3,0,40,92,0.435,0.421,22,34,0.647,8,46,54,11,9,7,8,37,102
2000-2001,Chucky Brown\brownch01,SF,32,GSW,6,0,74,9,20,0.45,0,2,0,9,18,0.5,0.45,6,10,0.6,3,15,18,5,3,1,2,10,24
2000-2001,Chucky Brown\brownch01,SF,32,CLE,20,2,265,31,75,0.413,0,1,0,31,74,0.419,0.413,16,24,0.667,5,31,36,6,6,6,6,27,78
2000-2001,Dee Brown\brownde01,PG,32,ORL,7,0,155,16,44,0.364,12,32,0.375,4,12,0.333,0.5,4,5,0.8,0,11,11,12,4,0,7,10,48
2000-2001,P.J. Brown\brownpj01,C,31,CHH,80,79,2811,249,561,0.444,0,4,0,249,557,0.447,0.444,178,209,0.852,257,485,742,127,78,92,108,260,676
2000-2001,Randy Brown\brownra02,PG,32,BOS,54,35,1238,100,237,0.422,0,3,0,100,234,0.427,0.422,23,40,0.575,23,76,99,154,62,10,56,132,223
2000-2001,Rick Brunson\brunsri01,PG,28,TOT,22,0,208,18,54,0.333,2,14,0.143,16,40,0.4,0.352,8,15,0.533,5,16,21,31,8,1,17,21,46
2000-2001,Rick Brunson\brunsri01,PG,28,BOS,7,0,142,10,35,0.286,2,11,0.182,8,24,0.333,0.314,4,9,0.444,2,7,9,24,7,1,9,16,26
2000-2001,Rick Brunson\brunsri01,PG,28,NYK,15,0,66,8,19,0.421,0,3,0,8,16,0.5,0.421,4,6,0.667,3,9,12,7,1,0,8,5,20
2000-2001,Kobe Bryant\bryanko01,SG,22,LAL,68,68,2783,701,1510,0.464,61,200,0.305,640,1310,0.489,0.484,475,557,0.853,104,295,399,338,114,43,220,222,1938
2000-2001,Mark Bryant\bryanma01,PF,35,DAL,18,1,101,8,20,0.4,0,0,,8,20,0.4,0.4,3,5,0.6,4,17,21,3,1,2,5,29,19
2000-2001,Greg Buckner\buckngr01,SG,24,DAL,37,9,820,84,192,0.438,2,7,0.286,82,185,0.443,0.443,59,81,0.728,60,97,157,49,33,9,27,118,229
2000-2001,Jud Buechler\buechju01,SF,32,DET,57,3,737,76,164,0.463,32,77,0.416,44,87,0.506,0.561,9,12,0.75,20,74,94,39,21,10,25,83,193
2000-2001,Rodney Buford\buforro01,SF,23,PHI,47,0,573,104,241,0.432,16,38,0.421,88,203,0.433,0.465,24,29,0.828,16,58,74,17,17,6,29,68,248
2000-2001,Matt Bullard\bullama01,PF,33,HOU,61,5,1000,129,305,0.423,86,213,0.404,43,92,0.467,0.564,10,14,0.714,22,108,130,42,10,9,12,76,354
2000-2001,Scott Burrell\burresc01,SF,30,CHH,4,0,41,7,15,0.467,2,6,0.333,5,9,0.556,0.533,1,4,0.25,1,2,3,1,3,0,0,8,17
2000-2001,Jason Caffey\caffeja01,PF,27,MIL,70,33,1460,179,367,0.488,0,0,,179,367,0.488,0.488,142,211,0.673,135,218,353,53,38,25,77,184,500
2000-2001,Marcus Camby\cambyma01,C,26,NYK,63,63,2127,304,580,0.524,1,8,0.125,303,572,0.53,0.525,150,225,0.667,196,527,723,52,66,136,63,205,759
2000-2001,Elden Campbell\campbel01,PF,32,CHH,78,78,2337,367,834,0.44,0,6,0,367,828,0.443,0.44,288,406,0.709,157,451,608,104,60,140,144,280,1022
2000-2001,Brian Cardinal\cardibr01,PF,23,DET,15,0,126,10,31,0.323,0,5,0,10,26,0.385,0.323,11,18,0.611,8,15,23,3,7,2,9,27,31
2000-2001,Chris Carr\carrch01,SG,26,BOS,35,0,309,53,112,0.473,17,37,0.459,36,75,0.48,0.549,46,60,0.767,11,33,44,11,4,3,19,45,169
2000-2001,Anthony Carter\cartean01,PG,25,MIA,72,6,1630,195,480,0.406,6,40,0.15,189,440,0.43,0.413,65,103,0.631,46,134,180,268,73,10,119,154,461
2000-2001,Vince Carter\cartevi01,SF,24,TOR,75,75,2979,762,1656,0.46,162,397,0.408,600,1259,0.477,0.509,384,502,0.765,176,240,416,291,114,82,167,205,2070
2000-2001,Sam Cassell\cassesa01,PG,31,MIL,76,75,2709,537,1132,0.474,30,98,0.306,507,1034,0.49,0.488,277,323,0.858,46,244,290,580,88,8,220,214,1381
2000-2001,Kelvin Cato\catoke01,C,26,HOU,35,13,624,64,111,0.577,0,0,,64,111,0.577,0.577,37,57,0.649,47,94,141,11,13,31,25,89,165
2000-2001,Duane Causwell\causwdu01,C,32,MIA,31,14,384,32,85,0.376,0,0,,32,85,0.376,0.376,12,25,0.48,23,60,83,5,8,18,23,67,76
2000-2001,Cedric Ceballos\cebalce01,SF,31,TOT,40,0,559,101,229,0.441,22,73,0.301,79,156,0.506,0.489,37,43,0.86,34,72,106,20,16,7,32,61,261
2000-2001,Cedric Ceballos\cebalce01,SF,31,DET,13,0,166,28,71,0.394,11,40,0.275,17,31,0.548,0.472,8,10,0.8,7,19,26,7,6,3,9,19,75
2000-2001,Cedric Ceballos\cebalce01,SF,31,MIA,27,0,393,73,158,0.462,11,33,0.333,62,125,0.496,0.497,29,33,0.879,27,53,80,13,10,4,23,42,186
2000-2001,Calbert Cheaney\cheanca01,SG,29,DEN,9,5,153,10,30,0.333,0,0,,10,30,0.333,0.333,1,2,0.5,5,15,20,9,4,2,5,14,21
2000-2001,Chris Childs\childch01,PG,33,TOT,77,5,1859,135,335,0.403,32,106,0.302,103,229,0.45,0.451,60,71,0.845,24,178,202,355,59,15,156,242,362
2000-2001,Chris Childs\childch01,PG,33,NYK,51,5,1309,93,222,0.419,20,64,0.313,73,158,0.462,0.464,39,46,0.848,14,124,138,236,37,7,98,160,245
2000-2001,Chris Childs\childch01,PG,33,TOR,26,0,550,42,113,0.372,12,42,0.286,30,71,0.423,0.425,21,25,0.84,10,54,64,119,22,8,58,82,117
2000-2001,Doug Christie\chrisdo01,SG,30,SAC,81,81,2939,311,788,0.395,94,250,0.376,217,538,0.403,0.454,280,312,0.897,95,260,355,289,183,45,154,224,996
2000-2001,Keon Clark\clarkke01,PF,25,TOT,81,3,1720,249,519,0.48,0,1,0,249,518,0.481,0.48,142,240,0.592,136,298,434,72,32,154,90,244,640
2000-2001,Keon Clark\clarkke01,PF,25,DEN,35,3,752,82,199,0.412,0,0,,82,199,0.412,0.412,63,105,0.6,58,128,186,34,16,44,48,101,227
2000-2001,Keon Clark\clarkke01,PF,25,TOR,46,0,968,167,320,0.522,0,1,0,167,319,0.524,0.522,79,135,0.585,78,170,248,38,16,110,42,143,413
2000-2001,Mateen Cleaves\cleavma01,PG,23,DET,78,8,1268,160,400,0.4,5,17,0.294,155,383,0.405,0.406,97,137,0.708,26,106,132,207,49,1,139,153,422
2000-2001,John Coker\cokerjo01,C,29,GSW,6,0,32,1,8,0.125,0,0,,1,8,0.125,0.125,0,0,,3,2,5,2,1,0,2,4,2
2000-2001,Derrick Coleman\colemde01,PF,33,CHH,34,3,683,97,255,0.38,20,51,0.392,77,204,0.377,0.42,63,92,0.685,46,138,184,39,10,21,42,53,277
2000-2001,Bimbo Coles\colesbi01,PG,32,CLE,47,0,804,91,239,0.381,2,16,0.125,89,223,0.399,0.385,48,56,0.857,9,39,48,138,27,6,59,87,232
2000-2001,Jason Collier\collija02,C,23,HOU,23,0,222,27,71,0.38,0,1,0,27,70,0.386,0.38,17,24,0.708,12,25,37,6,2,3,11,27,71
2000-2001,Sean Colson\colsose01,PG,25,TOT,13,0,44,6,24,0.25,1,5,0.2,5,19,0.263,0.271,2,4,0.5,2,4,6,10,1,0,2,6,15
2000-2001,Sean Colson\colsose01,PG,25,ATL,3,0,14,0,5,0,0,1,0,0,4,0,0,0,0,,0,3,3,3,0,0,2,0,0
2000-2001,Sean Colson\colsose01,PG,25,HOU,10,0,30,6,19,0.316,1,4,0.25,5,15,0.333,0.342,2,4,0.5,2,1,3,7,1,0,0,6,15
2000-2001,Tyrone Corbin\corbity01,SF,38,TOR,15,1,117,9,38,0.237,0,5,0,9,33,0.273,0.237,2,4,0.5,3,10,13,4,2,0,3,18,20
2000-2001,Chris Crawford\crawfch01,PF,25,ATL,47,22,901,122,270,0.452,6,22,0.273,116,248,0.468,0.463,68,83,0.819,28,82,110,37,21,16,62,117,318
2000-2001,Jamal Crawford\crawfja01,PG,20,CHI,61,8,1050,107,304,0.352,41,117,0.35,66,187,0.353,0.419,27,34,0.794,9,80,89,141,43,14,85,68,282
2000-2001,Austin Croshere\croshau01,PF,25,IND,81,23,1874,276,701,0.394,70,207,0.338,206,494,0.417,0.444,200,231,0.866,123,264,387,92,36,50,136,180,822
2000-2001,John Crotty\crottjo01,PG,31,UTA,31,0,264,22,65,0.338,4,7,0.571,18,58,0.31,0.369,17,19,0.895,13,15,28,34,6,0,19,32,65
2000-2001,Vonteego Cummings\cummivo01,PG,24,GSW,66,11,1495,178,517,0.344,48,143,0.336,130,374,0.348,0.391,79,116,0.681,47,90,137,227,67,14,91,160,483
2000-2001,Bill Curley\curlebi01,PF,28,TOT,20,2,192,25,47,0.532,1,2,0.5,24,45,0.533,0.543,12,19,0.632,21,16,37,3,7,9,16,45,63
2000-2001,Bill Curley\curlebi01,PF,28,DAL,5,0,15,1,4,0.25,0,1,0,1,3,0.333,0.25,1,4,0.25,0,0,0,0,1,1,2,4,3
2000-2001,Bill Curley\curlebi01,PF,28,GSW,15,2,177,24,43,0.558,1,1,1,23,42,0.548,0.57,11,15,0.733,21,16,37,3,6,8,14,41,60
2000-2001,Dell Curry\curryde01,SG,36,TOR,71,1,956,162,382,0.424,62,145,0.428,100,237,0.422,0.505,43,51,0.843,16,69,85,75,27,8,39,66,429
2000-2001,Michael Curry\currymi01,SG,32,DET,68,58,1485,145,319,0.455,4,9,0.444,141,310,0.455,0.461,62,73,0.849,21,100,121,132,27,3,61,173,356
2000-2001,Erick Dampier\dampier01,C,25,GSW,43,26,1038,126,314,0.401,0,2,0,126,312,0.404,0.401,67,126,0.532,97,153,250,59,17,58,82,123,319
2000-2001,Antonio Daniels\daniean01,PG,25,SAS,79,23,2060,275,588,0.468,74,183,0.404,201,405,0.496,0.531,121,156,0.776,26,137,163,304,61,14,109,120,745
2000-2001,Kornel David\davidko01,SF,29,TOT,27,0,209,25,51,0.49,0,0,,25,51,0.49,0.49,12,13,0.923,15,37,52,7,6,4,11,28,62
2000-2001,Kornel David\davidko01,SF,29,TOR,17,0,140,15,29,0.517,0,0,,15,29,0.517,0.517,12,13,0.923,9,24,33,4,2,3,7,20,42
2000-2001,Kornel David\davidko01,SF,29,DET,10,0,69,10,22,0.455,0,0,,10,22,0.455,0.455,0,0,,6,13,19,3,4,1,4,8,20
2000-2001,Antonio Davis\davisan01,C,32,TOR,78,77,2729,375,866,0.433,0,1,0,375,865,0.434,0.433,319,423,0.754,274,513,787,106,22,151,135,230,1069
2000-2001,Baron Davis\davisba01,PG,21,CHH,82,82,3192,409,957,0.427,85,274,0.31,324,683,0.474,0.472,228,337,0.677,129,279,408,598,170,36,226,267,1131
2000-2001,Dale Davis\davisda01,C,31,POR,81,43,2162,242,487,0.497,0,4,0,242,483,0.501,0.497,96,152,0.632,233,373,606,103,44,76,67,199,580
2000-2001,Emanual Davis\davisem01,SG,32,SEA,62,39,1290,133,318,0.418,50,127,0.394,83,191,0.435,0.497,45,55,0.818,28,126,154,137,64,12,77,101,361
2000-2001,Hubert Davis\davishu01,PG,30,TOT,66,18,1692,196,433,0.453,78,171,0.456,118,262,0.45,0.543,54,62,0.871,28,111,139,110,35,1,81,121,524
2000-2001,Hubert Davis\davishu01,PG,30,DAL,51,7,1261,139,314,0.443,58,133,0.436,81,181,0.448,0.535,35,41,0.854,18,91,109,61,29,1,56,92,371
2000-2001,Hubert Davis\davishu01,PG,30,WAS,15,11,431,57,119,0.479,20,38,0.526,37,81,0.457,0.563,19,21,0.905,10,20,30,49,6,0,25,29,153
2000-2001,Ricky Davis\davisri01,SG,21,MIA,7,0,70,12,29,0.414,1,1,1,11,28,0.393,0.431,7,8,0.875,1,6,7,11,5,2,5,7,32
2000-2001,Terry Davis\daviste01,PF,33,DEN,19,1,228,12,25,0.48,0,0,,12,25,0.48,0.48,9,22,0.409,24,29,53,7,1,1,5,34,33
2000-2001,Todd Day\dayto01,SG,31,MIN,31,0,345,44,118,0.373,26,69,0.377,18,49,0.367,0.483,18,23,0.783,10,27,37,28,10,7,24,52,132
2000-2001,Andrew DeClercq\declean01,C,27,ORL,67,51,903,107,193,0.554,0,0,,107,193,0.554,0.554,47,82,0.573,91,145,236,32,41,33,51,198,261
2000-2001,Vinny Del Negro\delnevi01,PG,34,TOT,65,1,922,106,234,0.453,1,13,0.077,105,221,0.475,0.455,41,44,0.932,12,70,82,126,26,3,34,78,254
2000-2001,Vinny Del Negro\delnevi01,PG,34,GSW,29,1,396,30,90,0.333,1,9,0.111,29,81,0.358,0.339,16,16,1,4,27,31,62,6,0,15,36,77
2000-2001,Vinny Del Negro\delnevi01,PG,34,PHO,36,0,526,76,144,0.528,0,4,0,76,140,0.543,0.528,25,28,0.893,8,43,51,64,20,3,19,42,177
2000-2001,Tony Delk\delkto01,SG,27,PHO,82,11,2288,383,923,0.415,54,168,0.321,329,755,0.436,0.444,185,235,0.787,76,185,261,160,75,17,101,171,1005
2000-2001,Derrick Dial\dialde01,SG,25,SAS,33,0,207,36,83,0.434,2,10,0.2,34,73,0.466,0.446,12,21,0.571,12,26,38,21,4,6,12,22,86
2000-2001,Michael Dickerson\dickemi01,SG,25,VAN,70,69,2618,425,1020,0.417,86,230,0.374,339,790,0.429,0.459,206,270,0.763,70,159,229,233,62,27,162,207,1142
2000-2001,Vlade Divac\divacvl01,C,32,SAC,81,81,2420,364,755,0.482,4,14,0.286,360,741,0.486,0.485,242,350,0.691,207,466,673,231,87,93,192,242,974
2000-2001,Michael Doleac\doleami01,C,23,ORL,77,21,1398,220,527,0.417,0,3,0,220,524,0.42,0.417,50,59,0.847,70,203,273,65,37,41,59,239,490
2000-2001,Keyon Dooling\doolike01,PG,20,LAC,76,1,1237,148,362,0.409,28,80,0.35,120,282,0.426,0.448,125,179,0.698,8,81,89,177,41,11,94,107,449
2000-2001,Sherman Douglas\douglsh01,PG,34,NJN,59,7,1094,122,303,0.403,8,40,0.2,114,263,0.433,0.416,86,115,0.748,21,53,74,144,36,4,79,93,338
2000-2001,Bryce Drew\drewbr01,PG,26,CHI,48,41,1305,124,327,0.379,40,105,0.381,84,222,0.378,0.44,14,19,0.737,12,57,69,185,32,3,68,99,302
2000-2001,Chris Dudley\dudlech02,C,35,PHO,53,33,613,29,73,0.397,0,0,,29,73,0.397,0.397,14,36,0.389,64,119,183,18,14,29,26,111,72
2000-2001,Tim Duncan\duncati01,PF,24,SAS,82,82,3174,702,1406,0.499,7,27,0.259,695,1379,0.504,0.502,409,662,0.618,259,738,997,245,70,192,242,247,1820
2000-2001,Tyus Edney\edneyty01,PG,27,IND,24,0,263,35,91,0.385,1,6,0.167,34,85,0.4,0.39,35,39,0.897,5,19,24,54,17,0,25,17,106
2000-2001,Kevin Edwards\edwarke01,SG,35,VAN,46,5,634,56,170,0.329,5,19,0.263,51,151,0.338,0.344,43,53,0.811,23,59,82,52,29,8,37,46,160
2000-2001,Howard Eisley\eisleho01,SG,28,DAL,82,40,2426,265,675,0.393,107,269,0.398,158,406,0.389,0.472,104,126,0.825,23,174,197,295,99,12,102,218,741
2000-2001,Obinna Ekezie\ekeziob01,PF,25,TOT,33,0,281,32,81,0.395,0,0,,32,81,0.395,0.395,37,53,0.698,31,47,78,9,5,5,14,48,101
2000-2001,Obinna Ekezie\ekeziob01,PF,25,WAS,29,0,273,32,77,0.416,0,0,,32,77,0.416,0.416,37,53,0.698,31,45,76,9,5,5,14,46,101
2000-2001,Obinna Ekezie\ekeziob01,PF,25,DAL,4,0,8,0,4,0,0,0,,0,4,0,0,0,0,,0,2,2,0,0,0,0,2,0
2000-2001,Khalid El-Amin\elamikh01,PG,21,CHI,50,14,936,115,311,0.37,28,84,0.333,87,227,0.383,0.415,56,72,0.778,21,60,81,145,48,2,54,99,314
2000-2001,Mario Elie\eliema01,SG,37,PHO,68,67,1506,104,246,0.423,36,100,0.36,68,146,0.466,0.496,55,69,0.797,38,117,155,131,58,12,60,112,299
2000-2001,Sean Elliott\elliose01,SF,32,SAS,52,34,1229,147,339,0.434,55,129,0.426,92,210,0.438,0.515,60,84,0.714,17,153,170,81,23,25,51,80,409
2000-2001,LaPhonso Ellis\ellisla01,PF,30,MIN,82,5,1948,298,642,0.464,7,22,0.318,291,620,0.469,0.47,169,214,0.79,199,295,494,93,67,74,108,290,772
2000-2001,Pervis Ellison\ellispe01,C,33,SEA,9,0,40,2,7,0.286,0,0,,2,7,0.286,0.286,2,2,1,2,10,12,3,0,2,3,13,6
2000-2001,Evan Eschmeyer\eschmev01,C,25,NJN,74,51,1331,92,200,0.46,0,0,,92,200,0.46,0.46,67,102,0.657,135,231,366,40,41,58,53,220,251
2000-2001,Patrick Ewing*\ewingpa01,C,38,SEA,79,79,2107,294,684,0.43,0,2,0,294,682,0.431,0.43,172,251,0.685,124,461,585,92,53,91,151,229,760
2000-2001,Jamie Feick\feickja01,C,26,NJN,6,0,149,8,23,0.348,0,0,,8,23,0.348,0.348,6,12,0.5,12,44,56,5,8,3,7,15,22
2000-2001,Danny Ferry\ferryda01,SF,34,SAS,80,29,1688,178,375,0.475,70,156,0.449,108,219,0.493,0.568,22,30,0.733,55,168,223,71,28,21,50,169,448
2000-2001,Michael Finley\finlemi01,SF,27,DAL,82,82,3443,711,1552,0.458,91,263,0.346,620,1289,0.481,0.487,252,325,0.775,109,316,425,360,118,32,190,174,1765
2000-2001,Derek Fisher\fishede01,PG,26,LAL,20,20,709,77,187,0.412,25,63,0.397,52,124,0.419,0.479,50,62,0.806,5,54,59,87,39,2,29,50,229
2000-2001,Marcus Fizer\fizerma01,PF,22,CHI,72,13,1580,278,646,0.43,10,39,0.256,268,607,0.442,0.438,117,161,0.727,76,237,313,76,30,19,124,175,683
2000-2001,Danny Fortson\fortsda01,PF,24,GSW,6,6,203,29,50,0.58,0,0,,29,50,0.58,0.58,42,54,0.778,29,69,98,5,2,0,10,22,100
2000-2001,Greg Foster\fostegr01,C,32,LAL,62,8,451,56,133,0.421,3,9,0.333,53,124,0.427,0.432,10,14,0.714,29,83,112,32,9,12,25,76,125
2000-2001,Jeff Foster\fosteje01,C,24,IND,71,9,1152,100,213,0.469,2,7,0.286,98,206,0.476,0.474,47,91,0.516,144,245,389,33,39,28,52,152,249
2000-2001,Rick Fox\foxri01,SF,31,LAL,82,77,2291,287,646,0.444,118,300,0.393,169,346,0.488,0.536,95,122,0.779,80,245,325,262,70,29,136,225,787
2000-2001,Adonal Foyle\foylead01,C,25,GSW,58,37,1457,156,375,0.416,0,0,,156,375,0.416,0.416,30,68,0.441,156,249,405,48,31,156,79,136,342
2000-2001,Steve Francis\francst01,PG,23,HOU,80,79,3194,550,1219,0.451,133,336,0.396,417,883,0.472,0.506,358,438,0.817,190,363,553,517,141,31,265,274,1591
2000-2001,Todd Fuller\fulleto02,C,26,MIA,10,0,77,10,35,0.286,0,0,,10,35,0.286,0.286,8,8,1,7,11,18,1,3,2,3,10,28
2000-2001,Lawrence Funderburke\fundela01,PF,30,SAC,59,2,698,120,242,0.496,0,0,,120,242,0.496,0.496,48,77,0.623,74,122,196,17,9,13,32,44,288
2000-2001,Ruben Garces\garceru01,PF,27,TOT,13,0,73,7,22,0.318,0,0,,7,22,0.318,0.318,2,8,0.25,16,13,29,5,3,2,5,14,16
2000-2001,Ruben Garces\garceru01,PF,27,PHO,10,0,62,7,15,0.467,0,0,,7,15,0.467,0.467,2,8,0.25,12,10,22,4,2,1,5,14,16
2000-2001,Ruben Garces\garceru01,PF,27,GSW,3,0,11,0,7,0,0,0,,0,7,0,0,0,0,,4,3,7,1,1,1,0,0,0
2000-2001,Chris Garner\garnech01,PG,25,GSW,8,0,149,7,37,0.189,0,7,0,7,30,0.233,0.189,5,6,0.833,2,10,12,18,7,1,9,18,19
2000-2001,Kevin Garnett\garneke01,PF,24,MIN,81,81,3202,704,1475,0.477,19,66,0.288,685,1409,0.486,0.484,357,467,0.764,219,702,921,401,111,145,230,204,1784
2000-2001,Dean Garrett\garrede01,C,34,MIN,70,21,831,75,156,0.481,0,0,,75,156,0.481,0.481,27,39,0.692,65,152,217,24,26,49,25,93,177
2000-2001,Pat Garrity\garripa01,SF,24,ORL,76,1,1579,223,576,0.387,97,224,0.433,126,352,0.358,0.471,85,98,0.867,51,159,210,51,40,15,68,241,628
2000-2001,Chris Gatling\gatlich01,PF,33,CLE,74,6,1670,329,733,0.449,28,92,0.304,301,641,0.47,0.468,156,228,0.684,99,292,391,61,52,27,119,185,842
2000-2001,Matt Geiger\geigema01,C,31,PHI,35,4,542,88,224,0.393,0,2,0,88,222,0.396,0.393,37,54,0.685,50,89,139,14,12,8,25,73,213
2000-2001,Devean George\georgde01,SF,23,LAL,59,1,593,64,207,0.309,15,68,0.221,49,139,0.353,0.345,39,55,0.709,35,75,110,19,15,15,34,87,182
2000-2001,Eddie Gill\gilled01,PG,22,NJN,8,0,152,16,41,0.39,3,9,0.333,13,32,0.406,0.427,4,5,0.8,0,9,9,24,4,1,10,9,39
2000-2001,Kendall Gill\gillke01,SG,32,NJN,31,26,892,107,323,0.331,4,14,0.286,103,309,0.333,0.337,65,90,0.722,32,99,131,87,47,7,48,64,283
2000-2001,Dion Glover\glovedi01,SG,22,ATL,57,7,929,141,336,0.42,9,46,0.196,132,290,0.455,0.433,47,69,0.681,39,92,131,69,49,10,54,92,338
2000-2001,Anthony Goldwire\goldwan01,PG,29,DEN,20,0,201,30,80,0.375,9,34,0.265,21,46,0.457,0.431,13,17,0.765,1,11,12,34,9,0,15,13,82
2000-2001,Steve Goodrich\goodrst01,PF,24,CHI,12,0,133,7,18,0.389,1,3,0.333,6,15,0.4,0.417,4,7,0.571,7,14,21,6,2,1,8,14,19
2000-2001,Brian Grant\grantbr01,C,28,MIA,82,79,2771,484,1010,0.479,0,1,0,484,1009,0.48,0.479,282,354,0.797,217,501,718,101,60,71,170,293,1250
2000-2001,Gary Grant\grantga01,PG,35,POR,4,0,17,5,7,0.714,0,0,,5,7,0.714,0.714,0,0,,0,0,0,1,0,0,0,1,10
2000-2001,Horace Grant\grantho01,PF,35,LAL,77,77,2390,263,569,0.462,0,3,0,263,566,0.465,0.462,131,169,0.775,220,325,545,121,51,61,48,181,657
2000-2001,A.C. Green\greenac01,PF,37,MIA,82,1,1411,144,324,0.444,0,6,0,144,318,0.453,0.444,79,111,0.712,107,206,313,39,30,8,45,119,367
2000-2001,Adrian Griffin\griffad01,SF,26,BOS,44,0,377,33,97,0.34,9,26,0.346,24,71,0.338,0.387,18,24,0.75,27,60,87,27,18,5,18,45,93
2000-2001,Tom Gugliotta\guglito01,PF,31,PHO,57,2,1159,149,380,0.392,3,12,0.25,146,368,0.397,0.396,61,77,0.792,76,179,255,55,47,21,51,110,362
2000-2001,A.J. Guyton\guytoaj01,PG,22,CHI,33,8,630,78,192,0.406,27,69,0.391,51,123,0.415,0.477,15,18,0.833,10,26,36,64,9,5,24,35,198
2000-2001,Darvin Ham\hamda01,SF,27,MIL,29,13,540,39,80,0.488,2,3,0.667,37,77,0.481,0.5,29,49,0.592,56,65,121,25,17,21,33,85,109
2000-2001,Richard Hamilton\hamilri01,SF,22,WAS,78,42,2519,547,1249,0.438,40,146,0.274,507,1103,0.46,0.454,277,319,0.868,75,163,238,224,75,10,201,203,1411
2000-2001,Zendon Hamilton\hamilze01,C,25,LAC,3,0,19,2,9,0.222,0,0,,2,9,0.222,0.222,5,8,0.625,3,5,8,0,0,0,2,4,9
2000-2001,Tom Hammonds\hammoto01,PF,33,MIN,7,0,30,3,10,0.3,0,0,,3,10,0.3,0.3,1,2,0.5,2,2,4,1,0,0,3,8,7
2000-2001,Anfernee Hardaway\hardaan01,SG,29,PHO,4,4,112,15,36,0.417,2,8,0.25,13,28,0.464,0.444,7,11,0.636,5,13,18,15,6,1,3,6,39
2000-2001,Tim Hardaway\hardati01,PG,34,MIA,77,77,2613,408,1042,0.392,189,517,0.366,219,525,0.417,0.482,145,181,0.801,26,178,204,483,90,6,189,155,1150
2000-2001,Ron Harper\harpero01,PG,37,LAL,47,46,1139,127,271,0.469,19,72,0.264,108,199,0.543,0.504,34,48,0.708,46,120,166,113,39,25,62,70,307
2000-2001,Matt Harpring\harprma01,SG,24,CLE,56,55,1615,238,524,0.454,13,52,0.25,225,472,0.477,0.467,134,165,0.812,90,152,242,102,42,17,90,161,623
2000-2001,Al Harrington\harrial01,PF,20,IND,78,38,1892,241,543,0.444,1,7,0.143,240,536,0.448,0.445,103,157,0.656,119,262,381,130,63,18,148,223,586
2000-2001,Othella Harrington\harriot01,C,27,TOT,74,45,1815,247,507,0.487,0,3,0,247,504,0.49,0.487,171,224,0.763,139,249,388,56,34,45,145,237,665
2000-2001,Othella Harrington\harriot01,C,27,VAN,44,40,1267,180,386,0.466,0,3,0,180,383,0.47,0.466,120,154,0.779,102,187,289,36,19,26,104,136,480
2000-2001,Othella Harrington\harriot01,C,27,NYK,30,5,548,67,121,0.554,0,0,,67,121,0.554,0.554,51,70,0.729,37,62,99,20,15,19,41,101,185
2000-2001,Lucious Harris\harrilu01,SG,30,NJN,73,50,2071,265,624,0.425,46,132,0.348,219,492,0.445,0.462,107,139,0.77,71,217,288,135,74,16,64,127,683
2000-2001,Jason Hart\hartja01,PG,22,MIL,1,0,10,1,1,1,0,0,,1,1,1,1,0,0,,0,0,0,1,0,0,2,0,2
2000-2001,Antonio Harvey\harvean01,PF,30,POR,12,0,72,13,28,0.464,0,0,,13,28,0.464,0.464,5,6,0.833,5,9,14,4,1,6,3,10,31
2000-2001,Donnell Harvey\harvedo01,PF,20,DAL,18,0,65,8,14,0.571,0,0,,8,14,0.571,0.571,6,16,0.375,6,14,20,2,3,1,7,15,22
2000-2001,Hersey Hawkins\hawkihe01,SG,34,CHH,59,0,681,56,137,0.409,17,46,0.37,39,91,0.429,0.471,54,63,0.857,17,63,80,72,33,9,19,45,183
2000-2001,Michael Hawkins\hawkimi01,PG,28,CLE,10,0,76,3,9,0.333,2,4,0.5,1,5,0.2,0.444,0,0,,2,3,5,13,2,0,6,13,8
2000-2001,Alan Henderson\hendeal01,PF,28,ATL,73,42,1810,298,671,0.444,0,1,0,298,670,0.445,0.444,173,271,0.638,180,226,406,50,51,29,126,164,769
2000-2001,Cedric Henderson\hendece02,SF,25,CLE,55,10,961,102,262,0.389,1,8,0.125,101,254,0.398,0.391,30,46,0.652,19,71,90,79,29,23,63,101,235
2000-2001,Chris Herren\herrech01,PG,25,BOS,25,7,408,29,96,0.302,16,55,0.291,13,41,0.317,0.385,9,12,0.75,4,17,21,56,14,0,20,43,83
2000-2001,Grant Hill\hillgr01,SF,28,ORL,4,4,133,19,43,0.442,1,1,1,18,42,0.429,0.453,16,26,0.615,8,17,25,25,5,2,11,9,55
2000-2001,Tyrone Hill\hillty01,PF,32,PHI,76,75,2363,278,587,0.474,0,1,0,278,586,0.474,0.474,172,273,0.63,239,448,687,48,37,27,127,242,728
2000-2001,Fred Hoiberg\hoibefr01,SG,28,CHI,74,37,2247,217,495,0.438,103,250,0.412,114,245,0.465,0.542,136,157,0.866,21,287,308,263,98,12,74,155,673
2000-2001,Robert Horry\horryro01,PF,30,LAL,79,1,1587,147,380,0.387,54,156,0.346,93,224,0.415,0.458,59,83,0.711,93,203,296,128,54,54,79,210,407
2000-2001,Eddie House\houseed01,PG,22,MIA,50,0,550,104,247,0.421,19,55,0.345,85,192,0.443,0.46,24,35,0.686,5,37,42,52,13,0,35,58,251
2000-2001,Allan Houston\houstal01,SG,29,NYK,78,78,2858,542,1208,0.449,96,252,0.381,446,956,0.467,0.488,279,307,0.909,20,263,283,173,52,10,161,190,1459
2000-2001,Juwan Howard\howarju01,PF,27,TOT,81,81,2974,583,1218,0.479,0,3,0,583,1215,0.48,0.479,296,383,0.773,171,401,572,224,75,37,242,292,1462
2000-2001,Juwan Howard\howarju01,PF,27,WAS,54,54,1981,392,827,0.474,0,0,,392,827,0.474,0.474,197,256,0.77,121,258,379,154,46,21,169,186,981
2000-2001,Juwan Howard\howarju01,PF,27,DAL,27,27,993,191,391,0.488,0,3,0,191,388,0.492,0.488,99,127,0.78,50,143,193,70,29,16,73,106,481
2000-2001,Troy Hudson\hudsotr01,PG,24,ORL,75,7,1008,125,372,0.336,22,109,0.202,103,263,0.392,0.366,85,104,0.817,38,67,105,162,37,3,92,82,357
2000-2001,Larry Hughes\hughela01,SG,22,GSW,50,45,1846,308,805,0.383,14,75,0.187,294,730,0.403,0.391,193,252,0.766,76,200,276,223,96,29,152,147,823
2000-2001,Lindsey Hunter\hunteli01,PG,30,MIL,82,5,2002,298,783,0.381,152,407,0.373,146,376,0.388,0.478,77,96,0.802,32,137,169,222,102,12,68,172,825
2000-2001,Zydrunas Ilgauskas\ilgauzy01,C,25,CLE,24,24,616,114,234,0.487,0,2,0,114,232,0.491,0.487,53,78,0.679,65,95,160,18,15,37,60,78,281
2000-2001,Allen Iverson*\iversal01,SG,25,PHI,71,71,2979,762,1813,0.42,98,306,0.32,664,1507,0.441,0.447,585,719,0.814,50,223,273,325,178,20,237,147,2207
2000-2001,Bobby Jackson\jacksbo01,PG,27,SAC,79,7,1648,231,526,0.439,39,104,0.375,192,422,0.455,0.476,65,88,0.739,74,172,246,161,87,7,103,139,566
2000-2001,Jaren Jackson\jacksja01,SG,33,SAS,16,0,114,16,40,0.4,7,18,0.389,9,22,0.409,0.488,0,2,0,1,11,12,7,5,0,3,13,39
2000-2001,Jim Jackson\jacksji01,SF,30,TOT,56,40,1690,239,632,0.378,26,80,0.325,213,552,0.386,0.399,139,169,0.822,53,171,224,163,53,10,130,139,643
2000-2001,Jim Jackson\jacksji01,SF,30,ATL,17,14,550,77,217,0.355,16,38,0.421,61,179,0.341,0.392,73,85,0.859,17,62,79,50,19,4,48,42,243
2000-2001,Jim Jackson\jacksji01,SF,30,CLE,39,26,1140,162,415,0.39,10,42,0.238,152,373,0.408,0.402,66,84,0.786,36,109,145,113,34,6,82,97,400
2000-2001,Marc Jackson\jacksma02,C,26,GSW,48,35,1410,237,508,0.467,5,23,0.217,232,485,0.478,0.471,154,192,0.802,119,242,361,59,34,27,93,138,633
2000-2001,Mark Jackson\jacksma01,PG,35,TOT,83,82,2588,244,583,0.419,70,207,0.338,174,376,0.463,0.479,73,93,0.785,63,242,305,661,84,7,175,139,631
2000-2001,Mark Jackson\jacksma01,PG,35,TOR,54,54,1802,170,403,0.422,57,165,0.345,113,238,0.475,0.493,64,76,0.842,42,143,185,498,63,7,117,83,461
2000-2001,Mark Jackson\jacksma01,PG,35,NYK,29,28,786,74,180,0.411,13,42,0.31,61,138,0.442,0.447,9,17,0.529,21,99,120,163,21,0,58,56,170
2000-2001,Stephen Jackson\jacksst02,SF,22,NJN,77,40,1660,243,572,0.425,52,155,0.335,191,417,0.458,0.47,97,135,0.719,41,167,208,140,86,14,130,166,635
2000-2001,Sam Jacobson\jacobsa01,PG,25,MIN,14,0,59,9,18,0.5,0,0,,9,18,0.5,0.5,2,3,0.667,3,3,6,4,3,0,0,19,20
2000-2001,Tim James\jamesti01,SF,24,CHH,30,0,197,16,52,0.308,1,3,0.333,15,49,0.306,0.317,12,14,0.857,15,20,35,8,2,5,8,27,45
2000-2001,Antawn Jamison\jamisan01,SF,24,GSW,82,82,3394,800,1812,0.442,62,205,0.302,738,1607,0.459,0.459,382,534,0.715,280,435,715,164,114,28,199,225,2044
2000-2001,Anthony Johnson\johnsan02,PG,26,TOT,53,0,511,53,152,0.349,1,5,0.2,52,147,0.354,0.352,23,33,0.697,10,34,44,78,23,6,34,62,130
2000-2001,Anthony Johnson\johnsan02,PG,26,ATL,25,0,279,26,71,0.366,0,3,0,26,68,0.382,0.366,12,17,0.706,3,20,23,34,17,5,20,41,64
2000-2001,Anthony Johnson\johnsan02,PG,26,CLE,28,0,232,27,81,0.333,1,2,0.5,26,79,0.329,0.34,11,16,0.688,7,14,21,44,6,1,14,21,66
2000-2001,Avery Johnson\johnsav01,PG,35,SAS,55,20,1290,134,300,0.447,1,6,0.167,133,294,0.452,0.448,41,60,0.683,21,64,85,237,33,4,60,90,310
2000-2001,DerMarr Johnson\johnsde03,SF,20,ATL,78,21,1313,146,390,0.374,41,127,0.323,105,263,0.399,0.427,64,87,0.736,56,122,178,64,43,30,93,134,397
2000-2001,Ervin Johnson\johnser02,C,33,MIL,82,19,1981,108,198,0.545,0,0,,108,198,0.545,0.545,50,93,0.538,205,408,613,40,44,97,47,257,266
2000-2001,Larry Johnson\johnsla02,PF,31,NYK,65,65,2105,246,598,0.411,51,163,0.313,195,435,0.448,0.454,102,128,0.797,90,273,363,127,39,29,97,209,645
2000-2001,Damon Jones\jonesda01,PG,24,VAN,71,10,1415,170,416,0.409,84,231,0.364,86,185,0.465,0.51,37,52,0.712,16,108,124,224,36,1,76,58,461
2000-2001,Eddie Jones\jonesed02,SG,29,MIA,63,58,2282,388,871,0.445,90,238,0.378,298,633,0.471,0.497,228,270,0.844,75,217,292,171,110,58,135,183,1094
2000-2001,Jumaine Jones\jonesju01,SF,21,PHI,65,0,866,122,275,0.444,20,60,0.333,102,215,0.474,0.48,40,53,0.755,63,126,189,32,30,15,39,68,304
2000-2001,Popeye Jones\jonespo01,PF,30,WAS,45,1,638,60,153,0.392,1,6,0.167,59,147,0.401,0.395,41,55,0.745,83,137,220,31,19,8,21,95,162
2000-2001,Garth Joseph\josepga01,C,27,TOT,4,0,16,1,5,0.2,0,0,,1,5,0.2,0.2,0,2,0,2,0,2,1,0,1,2,1,2
2000-2001,Garth Joseph\josepga01,C,27,TOR,2,0,8,1,2,0.5,0,0,,1,2,0.5,0.5,0,0,,2,0,2,1,0,0,1,1,2
2000-2001,Garth Joseph\josepga01,C,27,DEN,2,0,8,0,3,0,0,0,,0,3,0,0,0,2,0,0,0,0,0,0,1,1,0,0
2000-2001,Adam Keefe\keefead01,PF,30,GSW,67,13,836,64,159,0.403,1,3,0.333,63,156,0.404,0.406,39,63,0.619,90,119,209,36,28,20,40,102,168
2000-2001,Shawn Kemp\kempsh01,PF,31,POR,68,3,1083,168,413,0.407,4,11,0.364,164,402,0.408,0.412,101,131,0.771,63,196,259,65,45,23,99,184,441
2000-2001,Steve Kerr\kerrst01,PG,35,SAS,55,1,650,67,159,0.421,33,77,0.429,34,82,0.415,0.525,14,15,0.933,6,29,35,57,16,1,21,30,181
2000-2001,Jerome Kersey\kerseje01,SF,38,MIL,22,2,243,32,69,0.464,0,1,0,32,68,0.471,0.464,8,16,0.5,8,37,45,15,14,8,6,36,72
2000-2001,Lari Ketner\ketnela01,PF,23,IND,3,0,7,0,0,,0,0,,0,0,,,0,0,,0,0,0,1,0,0,2,0,0
2000-2001,Jason Kidd\kiddja01,PG,27,PHO,77,76,3065,451,1097,0.411,69,232,0.297,382,865,0.442,0.443,328,403,0.814,91,403,494,753,166,23,286,171,1299
2000-2001,Gerard King\kingge02,SF,28,WAS,45,3,706,90,176,0.511,0,0,,90,176,0.511,0.511,36,45,0.8,39,90,129,31,14,11,47,94,216
2000-2001,Brevin Knight\knighbr01,PG,25,TOT,53,43,1457,139,371,0.375,1,10,0.1,138,361,0.382,0.376,54,66,0.818,23,145,168,311,101,4,91,155,333
2000-2001,Brevin Knight\knighbr01,PG,25,CLE,6,0,93,2,15,0.133,0,0,,2,15,0.133,0.133,5,6,0.833,1,6,7,25,6,1,7,17,9
2000-2001,Brevin Knight\knighbr01,PG,25,ATL,47,43,1364,137,356,0.385,1,10,0.1,136,346,0.393,0.386,49,60,0.817,22,139,161,286,95,3,84,138,324
2000-2001,Travis Knight\knightr01,C,26,NYK,45,0,256,10,53,0.189,0,1,0,10,52,0.192,0.189,9,18,0.5,19,34,53,5,5,11,10,47,29
2000-2001,Toni Kukoc\kukocto01,SF,32,TOT,65,19,1597,275,582,0.473,70,157,0.446,205,425,0.482,0.533,101,160,0.631,66,193,259,199,48,11,111,98,721
2000-2001,Toni Kukoc\kukocto01,SF,32,PHI,48,5,979,151,330,0.458,32,78,0.41,119,252,0.472,0.506,52,88,0.591,47,115,162,93,35,6,60,62,386
2000-2001,Toni Kukoc\kukocto01,SF,32,ATL,17,14,618,124,252,0.492,38,79,0.481,86,173,0.497,0.567,49,72,0.681,19,78,97,106,13,5,51,36,335
2000-2001,Christian Laettner\laettch01,C-PF,31,TOT,78,48,1663,277,551,0.503,4,13,0.308,273,538,0.507,0.506,170,204,0.833,118,247,365,124,71,46,137,242,728
2000-2001,Christian Laettner\laettch01,C,31,DAL,53,35,930,165,323,0.511,1,3,0.333,164,320,0.513,0.512,67,82,0.817,75,137,212,67,40,27,70,159,398
2000-2001,Christian Laettner\laettch01,PF,31,WAS,25,13,733,112,228,0.491,3,10,0.3,109,218,0.5,0.498,103,122,0.844,43,110,153,57,31,19,67,83,330
2000-2001,Raef LaFrentz\lafrera01,C,24,DEN,78,74,2457,387,812,0.477,51,139,0.367,336,673,0.499,0.508,183,262,0.698,173,434,607,107,37,206,97,290,1008
2000-2001,Trajan Langdon\langdtr01,SG,24,CLE,65,5,1116,135,313,0.431,51,124,0.411,84,189,0.444,0.513,68,76,0.895,12,77,89,81,38,9,52,114,389
2000-2001,Dan Langhi\langhda01,SF,23,HOU,33,0,241,37,99,0.374,0,1,0,37,98,0.378,0.374,16,29,0.552,13,28,41,4,7,1,8,16,90
2000-2001,Voshon Lenard\lenarvo01,SG,27,DEN,80,58,2331,336,846,0.397,147,382,0.385,189,464,0.407,0.484,153,192,0.797,47,184,231,190,65,18,102,170,972
2000-2001,Quincy Lewis\lewisqu01,SF,23,UTA,35,2,402,50,123,0.407,9,25,0.36,41,98,0.418,0.443,15,21,0.714,14,33,47,18,10,10,17,78,124
2000-2001,Rashard Lewis\lewisra02,PF,21,SEA,78,78,2720,426,887,0.48,123,285,0.432,303,602,0.503,0.55,176,213,0.826,143,398,541,125,91,45,129,191,1151
2000-2001,Randy Livingston\livinra01,PG,25,GSW,2,0,7,0,2,0,0,1,0,0,1,0,0,0,0,,0,1,1,1,0,0,0,0,0
2000-2001,Art Long\longar01,SF,28,SAC,9,0,20,0,4,0,0,0,,0,4,0,0,0,2,0,2,6,8,1,0,3,2,5,0
2000-2001,Grant Long\longgr01,PF,34,VAN,66,27,1507,140,319,0.439,4,15,0.267,136,304,0.447,0.445,112,157,0.713,76,198,274,83,72,15,62,160,396
2000-2001,Luc Longley\longllu01,C,32,NYK,25,2,301,18,54,0.333,0,0,,18,54,0.333,0.333,13,17,0.765,26,40,66,7,3,9,22,51,49
2000-2001,Felipe Lopez\lopezfe01,SG-PG,26,TOT,70,48,1565,211,478,0.441,19,52,0.365,192,426,0.451,0.461,109,156,0.699,55,179,234,107,62,30,83,156,550
2000-2001,Felipe Lopez\lopezfe01,SG,26,WAS,47,38,1108,142,326,0.436,6,29,0.207,136,297,0.458,0.445,90,123,0.732,30,130,160,73,41,18,56,110,380
2000-2001,Felipe Lopez\lopezfe01,PG,26,MIN,23,10,457,69,152,0.454,13,23,0.565,56,129,0.434,0.497,19,33,0.576,25,49,74,34,21,12,27,46,170
2000-2001,Tyronn Lue\luety01,PG,23,LAL,38,1,468,50,117,0.427,11,34,0.324,39,83,0.47,0.474,19,24,0.792,5,27,32,45,19,0,27,54,130
2000-2001,George Lynch\lynchge01,SF,30,PHI,82,80,2649,274,616,0.445,15,57,0.263,259,559,0.463,0.457,123,171,0.719,200,390,590,139,99,30,109,222,686
2000-2001,Todd MacCulloch\maccuto01,C,25,PHI,63,3,597,109,185,0.589,0,0,,109,185,0.589,0.589,42,66,0.636,69,99,168,10,7,19,27,96,260
2000-2001,Don MacLean\macledo01,SF,31,MIA,8,1,76,10,20,0.5,2,2,1,8,18,0.444,0.55,9,12,0.75,7,11,18,4,5,1,10,9,31
2000-2001,Mark Madsen\madsema01,PF,25,LAL,70,3,641,55,113,0.487,1,1,1,54,112,0.482,0.491,26,37,0.703,74,78,152,24,8,8,27,111,137
2000-2001,Corey Maggette\maggeco01,SF,21,LAC,69,9,1359,225,487,0.462,17,56,0.304,208,431,0.483,0.479,223,288,0.774,88,203,291,82,35,9,106,140,690
2000-2001,Jamaal Magloire\magloja01,C,22,CHH,74,0,1095,122,271,0.45,0,2,0,122,269,0.454,0.45,95,145,0.655,103,192,295,27,18,78,61,139,339
2000-2001,Dan Majerle\majerda01,SG,35,MIA,53,19,1306,87,259,0.336,57,181,0.315,30,78,0.385,0.446,36,44,0.818,20,146,166,88,53,15,35,98,267
2000-2001,Karl Malone*\malonka01,PF,37,UTA,81,81,2895,670,1345,0.498,2,5,0.4,668,1340,0.499,0.499,536,676,0.793,114,555,669,361,93,62,244,216,1878
2000-2001,Matt Maloney\malonma01,PG,29,ATL,55,27,1403,146,348,0.42,51,142,0.359,95,206,0.461,0.493,26,34,0.765,14,103,117,154,56,5,70,94,369
2000-2001,Danny Manning\mannida01,PF,34,UTA,82,0,1305,247,500,0.494,7,28,0.25,240,472,0.508,0.501,102,140,0.729,66,148,214,92,47,29,96,219,603
2000-2001,Stephon Marbury\marbust01,PG,23,NJN,67,67,2557,563,1277,0.441,110,335,0.328,453,942,0.481,0.484,362,458,0.79,53,152,205,506,79,5,197,150,1598
2000-2001,Shawn Marion\mariosh01,SF,22,PHO,79,79,2857,557,1160,0.48,21,82,0.256,536,1078,0.497,0.489,234,289,0.81,220,628,848,160,132,108,129,211,1369
2000-2001,Donyell Marshall\marshdo01,SF,27,UTA,81,49,2326,427,849,0.503,41,128,0.32,386,721,0.535,0.527,205,273,0.751,172,394,566,133,85,78,128,196,1100
2000-2001,Darrick Martin\martida01,PG,29,SAC,31,0,176,29,76,0.382,14,27,0.519,15,49,0.306,0.474,31,35,0.886,2,14,16,14,7,0,10,27,103
2000-2001,Kenyon Martin\martike01,PF,23,NJN,68,68,2272,346,777,0.445,1,11,0.091,345,766,0.45,0.446,121,192,0.63,137,365,502,131,78,113,138,281,814
2000-2001,Jamal Mashburn\mashbja01,SF,28,CHH,76,76,2989,573,1388,0.413,103,289,0.356,470,1099,0.428,0.45,279,364,0.766,92,484,576,411,85,13,211,185,1528
2000-2001,Anthony Mason\masonan01,PF,34,MIA,80,80,3254,460,954,0.482,0,0,,460,954,0.482,0.482,370,474,0.781,169,601,770,248,80,25,179,231,1290
2000-2001,Desmond Mason\masonde01,SF,23,SEA,78,14,1522,189,439,0.431,18,67,0.269,171,372,0.46,0.451,67,91,0.736,72,177,249,63,39,20,53,146,463
2000-2001,Tony Massenburg\masseto01,PF,33,VAN,52,20,823,92,199,0.462,0,0,,92,199,0.462,0.462,49,70,0.7,75,135,210,9,10,28,48,122,233
2000-2001,Vernon Maxwell\maxweve01,PG,35,TOT,43,6,660,73,223,0.327,34,111,0.306,39,112,0.348,0.404,21,32,0.656,4,62,66,49,21,3,35,64,201
2000-2001,Vernon Maxwell\maxweve01,PG,35,PHI,24,6,375,42,125,0.336,21,64,0.328,21,61,0.344,0.42,15,22,0.682,3,34,37,29,12,0,18,33,120
2000-2001,Vernon Maxwell\maxweve01,PG,35,DAL,19,0,285,31,98,0.316,13,47,0.277,18,51,0.353,0.383,6,10,0.6,1,28,29,20,9,3,17,31,81
2000-2001,Walter McCarty\mccarwa01,PF,26,BOS,60,3,478,45,126,0.357,19,56,0.339,26,70,0.371,0.433,22,28,0.786,24,57,81,39,14,7,20,82,131
2000-2001,Dan McClintock\mcclida01,C,23,DEN,6,1,58,9,18,0.5,0,0,,9,18,0.5,0.5,0,5,0,10,7,17,1,0,2,3,11,18
2000-2001,George McCloud\mccloge01,SF,33,DEN,76,8,2007,250,655,0.382,77,234,0.329,173,421,0.411,0.44,152,181,0.84,55,169,224,279,53,27,117,165,729
2000-2001,Jelani McCoy\mccoyje01,C,23,SEA,70,44,1143,138,264,0.523,0,0,,138,264,0.523,0.523,41,93,0.441,92,159,251,57,18,49,75,141,317
2000-2001,Antonio McDyess\mcdyean01,PF,26,DEN,70,70,2555,577,1165,0.495,0,0,,577,1165,0.495,0.495,304,434,0.7,240,605,845,146,43,102,162,220,1458
2000-2001,Tracy McGrady*\mcgratr01,SG,21,ORL,77,77,3087,788,1724,0.457,59,166,0.355,729,1558,0.468,0.474,430,587,0.733,192,388,580,352,116,118,198,160,2065
2000-2001,Jim McIlvaine\mcilvji01,C,28,NJN,18,3,193,10,28,0.357,0,0,,10,28,0.357,0.357,8,12,0.667,8,27,35,4,7,15,9,35,28
2000-2001,Jeff McInnis\mcinnje01,PG,26,LAC,81,81,2831,432,933,0.463,52,144,0.361,380,789,0.482,0.491,130,161,0.807,41,179,220,447,75,7,113,199,1046
2000-2001,Derrick McKey\mckeyde01,SF,34,IND,66,20,987,60,136,0.441,4,20,0.2,56,116,0.483,0.456,21,27,0.778,49,127,176,74,48,13,47,136,145
2000-2001,Aaron McKie\mckieaa01,SG,28,PHI,76,33,2394,338,714,0.473,53,170,0.312,285,544,0.524,0.511,149,194,0.768,33,278,311,377,106,8,203,178,878
2000-2001,Roshown McLeod\mcleoro01,SF,25,TOT,35,25,922,145,332,0.437,2,22,0.091,143,310,0.461,0.44,45,51,0.882,38,82,120,58,23,8,58,90,337
2000-2001,Roshown McLeod\mcleoro01,SF,25,ATL,34,25,907,144,330,0.436,2,21,0.095,142,309,0.46,0.439,45,51,0.882,37,81,118,58,23,8,57,88,335
2000-2001,Roshown McLeod\mcleoro01,SF,25,PHI,1,0,15,1,2,0.5,0,1,0,1,1,1,0.5,0,0,,1,1,2,0,0,0,1,2,2
2000-2001,Paul McPherson\mcphepa01,PG,22,TOT,55,0,595,109,216,0.505,2,12,0.167,107,204,0.525,0.509,42,58,0.724,40,39,79,38,25,4,47,80,262
2000-2001,Paul McPherson\mcphepa01,PG,22,PHO,33,0,308,47,96,0.49,0,6,0,47,90,0.522,0.49,18,24,0.75,20,28,48,16,12,3,23,48,112
2000-2001,Paul McPherson\mcphepa01,PG,22,GSW,22,0,287,62,120,0.517,2,6,0.333,60,114,0.526,0.525,24,34,0.706,20,11,31,22,13,1,24,32,150
2000-2001,Stanislav Medvedenko\medvest01,PF,21,LAL,7,0,39,12,25,0.48,1,1,1,11,24,0.458,0.5,7,12,0.583,1,8,9,2,1,1,3,9,32
2000-2001,Ron Mercer\mercero01,SG,24,CHI,61,61,2535,500,1121,0.446,14,46,0.304,486,1075,0.452,0.452,188,228,0.825,72,164,236,201,78,27,129,148,1202
2000-2001,Chris Mihm\mihmch01,C,21,CLE,59,43,1166,173,391,0.442,0,1,0,173,390,0.444,0.442,100,126,0.794,106,174,280,16,20,53,80,156,446
2000-2001,Darius Miles\milesda01,SF,19,LAC,81,21,2133,318,630,0.505,1,19,0.053,317,611,0.519,0.506,124,238,0.521,127,350,477,99,51,125,147,191,761
2000-2001,Andre Miller\millean02,PG,24,CLE,82,82,2848,452,999,0.452,17,64,0.266,435,935,0.465,0.461,375,450,0.833,94,266,360,657,119,28,265,229,1296
2000-2001,Anthony Miller\millean01,PF,29,TOT,4,0,11,1,2,0.5,0,0,,1,2,0.5,0.5,0,0,,0,2,2,0,0,0,1,1,2
2000-2001,Anthony Miller\millean01,PF,29,ATL,2,0,6,1,2,0.5,0,0,,1,2,0.5,0.5,0,0,,0,2,2,0,0,0,1,0,2
2000-2001,Anthony Miller\millean01,PF,29,HOU,1,0,3,0,0,,0,0,,0,0,,,0,0,,0,0,0,0,0,0,0,1,0
2000-2001,Anthony Miller\millean01,PF,29,PHI,1,0,2,0,0,,0,0,,0,0,,,0,0,,0,0,0,0,0,0,0,0,0
2000-2001,Brad Miller\millebr01,C,24,CHI,57,45,1434,168,386,0.435,1,5,0.2,167,381,0.438,0.437,168,226,0.743,144,275,419,107,33,38,73,176,505
2000-2001,Mike Miller\millemi01,SF,20,ORL,82,62,2390,368,845,0.436,148,364,0.407,220,481,0.457,0.523,91,128,0.711,66,261,327,140,51,19,97,200,975
2000-2001,Reggie Miller*\millere01,SG,35,IND,81,81,3181,517,1176,0.44,170,464,0.366,347,712,0.487,0.512,323,348,0.928,38,247,285,260,81,15,133,162,1527
2000-2001,Chris Mills\millsch01,SF,31,GSW,15,8,493,71,191,0.372,7,25,0.28,64,166,0.386,0.39,31,36,0.861,24,69,93,18,9,5,20,43,180
2000-2001,Terry Mills\millste01,PF,33,IND,14,0,113,11,34,0.324,3,17,0.176,8,17,0.471,0.368,0,0,,4,17,21,5,3,1,10,20,25
2000-2001,Sam Mitchell\mitchsa01,SF,37,MIN,82,4,983,118,289,0.408,9,43,0.209,109,246,0.443,0.424,40,55,0.727,28,95,123,57,26,10,36,117,285
2000-2001,Cuttino Mobley\moblecu01,SG,25,HOU,79,49,3002,527,1214,0.434,90,252,0.357,437,962,0.454,0.471,394,474,0.831,83,314,397,195,84,26,165,169,1538
2000-2001,Nazr Mohammed\mohamna01,C,23,TOT,58,22,912,176,369,0.477,0,1,0,176,368,0.478,0.477,89,126,0.706,115,192,307,19,29,35,64,113,441
2000-2001,Nazr Mohammed\mohamna01,C,23,PHI,30,3,196,41,88,0.466,0,0,,41,88,0.466,0.466,14,28,0.5,18,37,55,2,6,7,9,40,96
2000-2001,Nazr Mohammed\mohamna01,C,23,ATL,28,19,716,135,281,0.48,0,1,0,135,280,0.482,0.48,75,98,0.765,97,155,252,17,23,28,55,73,345
2000-2001,Jerome Moiso\moisoje01,C,22,BOS,24,0,135,12,30,0.4,0,1,0,12,29,0.414,0.4,11,26,0.423,12,30,42,3,3,4,18,29,35
2000-2001,Eric Montross\montrer01,C,29,TOT,54,21,649,56,138,0.406,0,0,,56,138,0.406,0.406,8,31,0.258,52,121,173,19,11,26,41,115,120
2000-2001,Eric Montross\montrer01,C,29,DET,42,20,568,50,121,0.413,0,0,,50,121,0.413,0.413,7,26,0.269,43,101,144,15,8,23,37,100,107
2000-2001,Eric Montross\montrer01,C,29,TOR,12,1,81,6,17,0.353,0,0,,6,17,0.353,0.353,1,5,0.2,9,20,29,4,3,3,4,15,13
2000-2001,Mikki Moore\mooremi01,C,25,DET,81,2,1154,132,268,0.493,0,1,0,132,267,0.494,0.493,95,130,0.731,121,195,316,33,24,61,74,202,359
2000-2001,Hanno Mottola\mottoha01,SF,24,ATL,73,3,989,123,277,0.444,0,3,0,123,274,0.449,0.444,73,90,0.811,49,125,174,25,11,9,67,163,319
2000-2001,Alonzo Mourning*\mournal01,C,30,MIA,13,3,306,73,141,0.518,0,1,0,73,140,0.521,0.518,31,55,0.564,35,66,101,12,4,31,28,24,177
2000-2001,Chris Mullin*\mullich01,SF,37,GSW,20,8,374,36,106,0.34,19,52,0.365,17,54,0.315,0.429,24,28,0.857,10,31,41,19,16,10,19,28,115
2000-2001,Lamond Murray\murrala01,SF,27,CLE,78,46,2225,391,925,0.423,61,165,0.37,330,760,0.434,0.456,155,211,0.735,104,236,340,124,83,27,141,173,998
2000-2001,Tracy Murray\murratr01,SF,29,TOT,51,1,588,94,248,0.379,36,103,0.35,58,145,0.4,0.452,33,42,0.786,22,59,81,23,12,7,26,53,257
2000-2001,Tracy Murray\murratr01,SF,29,DEN,13,0,135,17,55,0.309,7,23,0.304,10,32,0.313,0.373,9,10,0.9,4,18,22,9,4,1,6,8,50
2000-2001,Tracy Murray\murratr01,SF,29,TOR,38,1,453,77,193,0.399,29,80,0.363,48,113,0.425,0.474,24,32,0.75,18,41,59,14,8,6,20,45,207
2000-2001,Dikembe Mutombo*\mutomdi01,C,34,TOT,75,75,2591,269,556,0.484,0,0,,269,556,0.484,0.484,211,291,0.725,307,708,1015,76,29,203,144,204,749
2000-2001,Dikembe Mutombo*\mutomdi01,C,34,ATL,49,49,1716,169,354,0.477,0,0,,169,354,0.477,0.477,107,154,0.695,188,505,693,54,20,137,92,139,445
2000-2001,Dikembe Mutombo*\mutomdi01,C,34,PHI,26,26,875,100,202,0.495,0,0,,100,202,0.495,0.495,104,137,0.759,119,203,322,22,9,66,52,65,304
2000-2001,Mamadou N'Diaye\ndiayma02,C,25,TOR,3,0,10,1,4,0.25,0,0,,1,4,0.25,0.25,2,2,1,1,1,2,0,0,0,0,3,4
2000-2001,Lee Nailon\nailole01,SF,25,CHH,42,0,469,66,136,0.485,0,1,0,66,135,0.489,0.485,32,43,0.744,29,63,92,24,9,5,27,60,164
2000-2001,Eduardo Najera\najered01,PF,24,DAL,40,4,431,58,111,0.523,1,3,0.333,57,108,0.528,0.527,14,33,0.424,41,54,95,27,13,8,17,48,131
2000-2001,Steve Nash\nashst01,PG,26,DAL,70,70,2387,386,792,0.487,89,219,0.406,297,573,0.518,0.544,231,258,0.895,46,177,223,509,72,5,205,158,1092
2000-2001,Tyrone Nesby\nesbyty01,SF-SG,25,TOT,62,34,1556,189,530,0.357,49,180,0.272,140,350,0.4,0.403,85,106,0.802,51,122,173,76,51,20,65,155,512
2000-2001,Tyrone Nesby\nesbyty01,SG,25,LAC,14,12,333,40,123,0.325,10,46,0.217,30,77,0.39,0.366,18,23,0.783,16,26,42,11,10,4,10,28,108
2000-2001,Tyrone Nesby\nesbyty01,SF,25,WAS,48,22,1223,149,407,0.366,39,134,0.291,110,273,0.403,0.414,67,83,0.807,35,96,131,65,41,16,55,127,404
2000-2001,Rasho Nesterovic\nestera01,C,24,MIN,73,39,1233,147,319,0.461,0,1,0,147,318,0.462,0.461,34,65,0.523,99,187,286,45,25,63,55,189,328
2000-2001,Ira Newble\newblir01,SF,26,SAS,27,6,184,21,55,0.382,4,9,0.444,17,46,0.37,0.418,8,16,0.5,13,22,35,6,2,4,7,18,54
2000-2001,Johnny Newman\newmajo01,SG,37,NJN,82,17,2049,291,695,0.419,59,176,0.335,232,519,0.447,0.461,254,297,0.855,34,142,176,115,63,10,106,229,895
2000-2001,Moochie Norris\norrimo01,PG,27,HOU,82,6,1654,184,413,0.446,25,89,0.281,159,324,0.491,0.476,151,194,0.778,44,154,198,283,69,2,107,84,544
2000-2001,Dirk Nowitzki\nowitdi01,PF,22,DAL,82,82,3125,591,1247,0.474,151,390,0.387,440,857,0.513,0.534,451,538,0.838,119,635,754,173,79,101,156,245,1784
2000-2001,Jermaine O'Neal\onealje01,C,22,IND,81,80,2641,404,868,0.465,0,5,0,404,863,0.468,0.465,233,388,0.601,249,545,794,98,49,228,161,280,1041
2000-2001,Shaquille O'Neal*\onealsh01,C,28,LAL,74,74,2924,813,1422,0.572,0,2,0,813,1420,0.573,0.572,499,972,0.513,291,649,940,277,47,204,218,256,2125
2000-2001,Charles Oakley\oaklech01,PF,37,TOR,78,77,2767,305,786,0.388,11,49,0.224,294,737,0.399,0.395,127,152,0.836,142,599,741,264,76,48,139,258,748
2000-2001,Lamar Odom\odomla01,PF,21,LAC,76,74,2836,481,1046,0.46,80,253,0.316,401,793,0.506,0.498,262,386,0.679,110,482,592,392,74,122,264,236,1304
2000-2001,Hakeem Olajuwon*\olajuha01,C,38,HOU,58,55,1545,283,568,0.498,0,1,0,283,567,0.499,0.498,123,198,0.621,124,307,431,72,70,88,81,141,689
2000-2001,Kevin Ollie\ollieke01,PG,28,TOT,70,4,925,76,192,0.396,1,3,0.333,75,189,0.397,0.398,63,89,0.708,16,79,95,146,30,1,49,84,216
2000-2001,Kevin Ollie\ollieke01,PG,28,NJN,19,0,161,5,27,0.185,0,0,,5,27,0.185,0.185,12,19,0.632,3,20,23,25,5,0,9,14,22
2000-2001,Kevin Ollie\ollieke01,PG,28,PHI,51,4,764,71,165,0.43,1,3,0.333,70,162,0.432,0.433,51,70,0.729,13,59,72,121,25,1,40,70,194
2000-2001,Michael Olowokandi\olowomi01,C,25,LAC,82,82,2127,308,708,0.435,0,0,,308,708,0.435,0.435,85,156,0.545,168,357,525,46,30,108,169,250,701
2000-2001,Greg Ostertag\ostergr01,C,27,UTA,81,3,1491,139,281,0.495,1,2,0.5,138,279,0.495,0.496,84,151,0.556,164,251,415,22,22,142,63,215,363
2000-2001,Bo Outlaw\outlabo01,PF,29,ORL,80,69,2534,226,368,0.614,1,2,0.5,225,366,0.615,0.615,129,225,0.573,211,408,619,225,105,137,141,241,582
2000-2001,Doug Overton\overtdo01,PG,31,TOT,21,10,475,52,139,0.374,11,36,0.306,41,103,0.398,0.414,10,16,0.625,4,35,39,72,8,0,31,37,125
2000-2001,Doug Overton\overtdo01,PG,31,BOS,7,1,144,15,44,0.341,1,4,0.25,14,40,0.35,0.352,7,11,0.636,3,12,15,19,4,0,13,15,38
2000-2001,Doug Overton\overtdo01,PG,31,CHH,2,0,15,2,2,1,0,0,,2,2,1,1,0,0,,0,0,0,0,1,0,3,2,4
2000-2001,Doug Overton\overtdo01,PG,31,NJN,12,9,316,35,93,0.376,10,32,0.313,25,61,0.41,0.43,3,5,0.6,1,23,24,53,3,0,15,20,83
2000-2001,Billy Owens\owensbi01,PF,31,DET,45,14,793,88,230,0.383,3,20,0.15,85,210,0.405,0.389,19,40,0.475,84,121,205,55,32,12,39,93,198
2000-2001,Olumide Oyedeji\oyedeol01,C,19,SEA,30,1,221,18,37,0.486,0,0,,18,37,0.486,0.486,9,12,0.75,24,43,67,2,7,10,11,40,45
2000-2001,Robert Pack\packro01,PG,31,DEN,74,11,1260,181,426,0.425,12,31,0.387,169,395,0.428,0.439,105,137,0.766,30,107,137,293,65,1,135,114,479
2000-2001,Scott Padgett\padgesc01,PF,24,UTA,27,0,127,18,43,0.419,5,9,0.556,13,34,0.382,0.477,15,20,0.75,19,20,39,5,6,3,10,21,56
2000-2001,Milt Palacio\palacmi01,PG,22,BOS,58,6,1141,126,267,0.472,12,36,0.333,114,231,0.494,0.494,78,92,0.848,25,77,102,151,48,0,80,83,342
2000-2001,Andy Panko\pankoan01,SF,23,ATL,1,0,1,0,0,,0,0,,0,0,,,0,0,,0,0,0,0,0,0,0,0,0
2000-2001,Cherokee Parks\parksch02,C,28,TOT,65,31,1054,134,274,0.489,0,6,0,134,268,0.5,0.489,31,44,0.705,71,158,229,46,25,36,41,122,299
2000-2001,Cherokee Parks\parksch02,C,28,WAS,13,0,178,18,38,0.474,0,0,,18,38,0.474,0.474,12,17,0.706,13,27,40,7,6,11,10,20,48
2000-2001,Cherokee Parks\parksch02,C,28,LAC,52,31,876,116,236,0.492,0,6,0,116,230,0.504,0.492,19,27,0.704,58,131,189,39,19,25,31,102,251
2000-2001,Ruben Patterson\patteru01,SF,25,SEA,76,22,2059,370,749,0.494,2,36,0.056,368,713,0.516,0.495,246,361,0.681,183,199,382,161,103,45,155,176,988
2000-2001,Gary Payton*\paytoga01,PG,32,SEA,79,79,3244,725,1591,0.456,102,272,0.375,623,1319,0.472,0.488,271,354,0.766,73,288,361,642,127,26,209,184,1823
2000-2001,Anthony Peeler\peelean01,SG,31,MIN,75,41,2126,308,732,0.421,100,256,0.391,208,476,0.437,0.489,75,87,0.862,44,148,192,192,91,18,105,166,791
2000-2001,Mike Penberthy\penbemi01,PG,26,LAL,53,0,851,92,222,0.414,55,139,0.396,37,83,0.446,0.538,28,31,0.903,10,53,63,71,22,2,34,57,267
2000-2001,Will Perdue\perduwi01,C,35,POR,13,0,58,6,9,0.667,0,0,,6,9,0.667,0.667,2,4,0.5,6,12,18,2,3,2,0,8,14
2000-2001,Sam Perkins\perkisa01,PF,39,IND,64,41,999,86,226,0.381,38,110,0.345,48,116,0.414,0.465,32,38,0.842,32,136,168,41,33,18,19,61,242
2000-2001,Elliot Perry\perryel01,PG,31,TOT,49,6,499,65,140,0.464,1,5,0.2,64,135,0.474,0.468,16,22,0.727,9,37,46,79,22,1,38,29,147
2000-2001,Elliot Perry\perryel01,PG,31,ORL,6,0,39,5,11,0.455,0,1,0,5,10,0.5,0.455,0,0,,1,3,4,5,3,0,6,1,10
2000-2001,Elliot Perry\perryel01,PG,31,PHO,43,6,460,60,129,0.465,1,4,0.25,59,125,0.472,0.469,16,22,0.727,8,34,42,74,19,1,32,28,137
2000-2001,Wesley Person\persowe01,SG,29,CLE,44,22,958,128,292,0.438,34,84,0.405,94,208,0.452,0.497,24,30,0.8,11,119,130,64,27,11,40,62,314
2000-2001,Morris Peterson\petermo01,SG,23,TOR,80,49,1809,290,673,0.431,63,165,0.382,227,508,0.447,0.478,104,145,0.717,112,147,259,105,63,20,78,164,747
2000-2001,Eric Piatkowski\piatker01,SG,30,LAC,81,40,2144,291,672,0.433,120,297,0.404,171,375,0.456,0.522,158,181,0.873,54,187,241,96,46,19,76,123,860
2000-2001,Paul Pierce\piercpa01,SF,23,BOS,82,82,3120,687,1513,0.454,147,384,0.383,540,1129,0.478,0.503,550,738,0.745,94,428,522,253,138,69,262,251,2071
2000-2001,Scottie Pippen*\pippesc01,SF,35,POR,64,60,2133,269,596,0.451,64,186,0.344,205,410,0.5,0.505,119,161,0.739,70,263,333,294,94,35,154,158,721
2000-2001,Scot Pollard\pollasc01,C,25,SAC,77,8,1658,185,395,0.468,0,2,0,185,393,0.471,0.468,128,171,0.749,173,292,465,47,48,97,66,206,498
2000-2001,Olden Polynice\polynol01,C,36,UTA,81,79,1619,206,415,0.496,0,1,0,206,414,0.498,0.496,17,65,0.262,157,221,378,31,27,77,78,241,429
2000-2001,Mark Pope\popema01,PF,28,MIL,63,45,942,62,142,0.437,5,24,0.208,57,118,0.483,0.454,22,35,0.629,56,91,147,38,16,26,17,140,151
2000-2001,Chris Porter\portech01,SF,22,GSW,51,35,1147,173,445,0.389,0,5,0,173,440,0.393,0.389,94,141,0.667,89,100,189,61,45,6,59,111,440
2000-2001,Terry Porter\portete01,PG,37,SAS,80,42,1678,197,440,0.448,87,205,0.424,110,235,0.468,0.547,92,116,0.793,24,177,201,251,52,11,104,88,573
2000-2001,James Posey\poseyja01,SF,24,DEN,82,82,2255,243,590,0.412,65,217,0.3,178,373,0.477,0.467,115,141,0.816,125,306,431,163,93,40,102,226,666
2000-2001,Lavor Postell\postela01,SG,22,NYK,26,0,169,17,54,0.315,3,11,0.273,14,43,0.326,0.343,22,27,0.815,8,17,25,5,4,2,17,12,59
2000-2001,Vitaly Potapenko\potapvi01,C,25,BOS,82,7,1901,248,521,0.476,0,0,,248,521,0.476,0.476,115,158,0.728,206,289,495,64,52,23,105,228,611
2000-2001,Brent Price\pricebr01,PG,32,VAN,6,0,30,3,11,0.273,1,4,0.25,2,7,0.286,0.318,6,7,0.857,1,3,4,5,2,0,4,8,13
2000-2001,Laron Profit\profila01,PG,23,WAS,35,12,605,56,142,0.394,7,26,0.269,49,116,0.422,0.419,33,45,0.733,18,46,64,89,36,11,46,43,152
2000-2001,Joel Przybilla\przybjo01,C,21,MIL,33,13,270,12,35,0.343,0,0,,12,35,0.343,0.343,3,11,0.273,29,42,71,2,3,30,13,56,27
2000-2001,Theo Ratliff\ratlith01,C,27,PHI,50,50,1800,228,457,0.499,0,0,,228,457,0.499,0.499,165,217,0.76,125,288,413,58,30,187,126,165,621
2000-2001,Eldridge Recasner\recasel01,PG,33,CHH,43,0,403,38,114,0.333,13,39,0.333,25,75,0.333,0.39,14,18,0.778,13,37,50,39,6,1,27,30,103
2000-2001,Michael Redd\reddmi01,SG,21,MIL,6,0,35,5,19,0.263,0,3,0,5,16,0.313,0.263,3,6,0.5,3,1,4,1,1,0,1,2,13
2000-2001,Bryant Reeves\reevebr01,C,27,VAN,75,48,1832,254,552,0.46,1,4,0.25,253,548,0.462,0.461,113,142,0.796,132,320,452,80,43,54,90,243,622
2000-2001,Don Reid\reiddo01,PF,27,ORL,65,7,764,82,145,0.566,0,0,,82,145,0.566,0.566,46,75,0.613,84,158,242,21,23,54,48,190,210
2000-2001,J.R. Reid\reidjr01,PF,32,CLE,6,0,39,2,5,0.4,0,0,,2,5,0.4,0.4,6,8,0.75,5,3,8,1,2,1,1,4,10
2000-2001,Glen Rice\ricegl01,SF,33,NYK,75,25,2212,331,752,0.44,82,211,0.389,249,541,0.46,0.495,155,182,0.852,61,246,307,89,41,13,96,179,899
2000-2001,Quentin Richardson\richaqu01,SG,20,LAC,76,28,1358,232,525,0.442,50,151,0.331,182,374,0.487,0.49,99,158,0.627,105,152,257,62,42,7,64,98,613
2000-2001,Mitch Richmond*\richmmi01,SG,35,WAS,37,30,1216,205,504,0.407,45,133,0.338,160,371,0.431,0.451,143,160,0.894,15,94,109,111,43,7,84,86,598
2000-2001,Isaiah Rider\rideris01,SG,29,LAL,67,6,1206,201,472,0.426,34,92,0.37,167,380,0.439,0.462,71,83,0.855,44,112,156,111,27,7,98,105,507
2000-2001,Terrance Roberson\roberte01,SF,24,CHH,3,0,13,0,2,0,0,1,0,0,1,0,0,0,0,,0,1,1,1,0,0,2,3,0
2000-2001,Clifford Robinson\robincl02,PF,34,PHO,82,82,2751,501,1186,0.422,90,249,0.361,411,937,0.439,0.46,253,357,0.709,105,229,334,237,87,82,186,258,1345
2000-2001,David Robinson*\robinda01,C,35,SAS,80,80,2371,400,823,0.486,0,1,0,400,822,0.487,0.486,351,470,0.747,208,483,691,116,80,197,122,212,1151
2000-2001,Eddie Robinson\robined01,SF,24,CHH,67,6,1201,216,407,0.531,2,4,0.5,214,403,0.531,0.533,64,88,0.727,60,138,198,59,50,32,43,66,498
2000-2001,Glenn Robinson\robingl01,SF,28,MIL,76,74,2813,684,1460,0.468,55,184,0.299,629,1276,0.493,0.487,251,306,0.82,124,402,526,252,86,62,219,191,1674
2000-2001,Jamal Robinson\robinja03,SF,27,MIA,6,0,72,3,22,0.136,0,2,0,3,20,0.15,0.136,0,0,,3,8,11,2,6,0,3,7,6
2000-2001,James Robinson\robinja02,PG,30,ORL,6,0,50,4,11,0.364,2,5,0.4,2,6,0.333,0.455,0,0,,0,8,8,0,4,1,4,5,10
2000-2001,Larry Robinson\robinla01,PG-SG,33,TOT,34,1,632,67,184,0.364,44,116,0.379,23,68,0.338,0.484,21,24,0.875,23,64,87,36,28,2,25,46,199
2000-2001,Larry Robinson\robinla01,SG,33,CLE,1,0,1,0,0,,0,0,,0,0,,,0,0,,0,0,0,0,0,0,1,0,0
2000-2001,Larry Robinson\robinla01,PG,33,ATL,33,1,631,67,184,0.364,44,116,0.379,23,68,0.338,0.484,21,24,0.875,23,64,87,36,28,2,24,46,199
2000-2001,Carlos Rogers\rogerca01,C,29,HOU,39,0,544,75,110,0.682,0,1,0,75,109,0.688,0.682,29,52,0.558,48,91,139,9,10,18,17,33,179
2000-2001,Rodney Rogers\rogerro01,SF,29,PHO,82,3,2183,377,876,0.43,56,189,0.296,321,687,0.467,0.462,188,247,0.761,94,265,359,180,97,47,157,269,998
2000-2001,Sean Rooks\rooksse01,C,31,LAC,82,0,1553,169,395,0.428,1,2,0.5,168,393,0.427,0.429,107,143,0.748,91,212,303,77,34,64,73,197,446
2000-2001,Jalen Rose\roseja01,SF,28,IND,72,72,2943,567,1242,0.457,59,174,0.339,508,1068,0.476,0.48,285,344,0.828,37,322,359,435,65,43,211,230,1478
2000-2001,Malik Rose\rosema01,PF,26,SAS,57,9,1219,160,368,0.435,3,17,0.176,157,351,0.447,0.439,114,160,0.713,95,213,308,48,59,40,74,148,437
2000-2001,Michael Ruffin\ruffimi01,PF,24,CHI,45,16,879,40,90,0.444,0,0,,40,90,0.444,0.444,39,77,0.506,101,161,262,39,30,38,46,131,119
2000-2001,Bryon Russell\russebr01,SF,30,UTA,78,46,2473,308,700,0.44,95,230,0.413,213,470,0.453,0.508,222,285,0.779,94,236,330,160,96,20,113,229,933
2000-2001,Arvydas Sabonis*\sabonar01,C,36,POR,61,42,1299,247,516,0.479,1,15,0.067,246,501,0.491,0.48,121,156,0.776,51,280,331,91,40,62,85,137,616
2000-2001,Soumaila Samake\samakso01,C,22,NJN,34,0,226,18,48,0.375,0,0,,18,48,0.375,0.375,10,24,0.417,22,31,53,1,2,14,4,23,46
2000-2001,Pepe Sanchez\sanchpe01,PG,23,TOT,29,0,150,9,28,0.321,0,1,0,9,27,0.333,0.321,2,2,1,3,12,15,41,11,1,6,21,20
2000-2001,Pepe Sanchez\sanchpe01,PG,23,ATL,5,0,34,0,7,0,0,0,,0,7,0,0,0,0,,1,0,1,5,2,0,3,3,0
2000-2001,Pepe Sanchez\sanchpe01,PG,23,PHI,24,0,116,9,21,0.429,0,1,0,9,20,0.45,0.429,2,2,1,2,12,14,36,9,1,3,18,20
2000-2001,Daniel Santiago\santida01,C,24,PHO,54,2,581,64,134,0.478,0,0,,64,134,0.478,0.478,42,61,0.689,35,67,102,11,17,21,47,101,170
2000-2001,Detlef Schrempf\schrede01,SF,38,POR,26,0,397,39,95,0.411,3,8,0.375,36,87,0.414,0.426,23,27,0.852,17,61,78,44,7,3,28,43,104
2000-2001,Shawnelle Scott\scottsh01,C,28,SAS,27,1,144,17,41,0.415,0,0,,17,41,0.415,0.415,9,22,0.409,23,27,50,4,5,6,11,23,43
2000-2001,Brian Shaw\shawbr01,SG,34,LAL,80,28,1833,164,411,0.399,42,135,0.311,122,276,0.442,0.45,51,64,0.797,48,256,304,258,49,27,97,159,421
2000-2001,Brian Skinner\skinnbr01,PF,24,LAC,39,23,584,64,161,0.398,0,0,,64,161,0.398,0.398,32,59,0.542,55,113,168,18,14,11,32,61,160
2000-2001,Reggie Slater\slatere01,PF,30,MIN,55,16,686,90,175,0.514,0,0,,90,175,0.514,0.514,74,110,0.673,78,108,186,26,18,9,43,126,254
2000-2001,Jabari Smith\smithja01,C,23,SAC,9,0,66,11,22,0.5,0,0,,11,22,0.5,0.5,4,6,0.667,1,7,8,6,4,0,3,7,26
2000-2001,Joe Smith\smithjo02,PF,25,DET,69,59,1941,308,765,0.403,0,5,0,308,760,0.405,0.403,231,287,0.805,160,331,491,79,47,50,88,258,847
2000-2001,Michael Smith\smithmi02,PF,28,WAS,79,29,1610,106,218,0.486,0,1,0,106,217,0.488,0.486,89,154,0.578,172,390,562,101,57,37,62,156,301
2000-2001,Mike Smith\smithmi03,SF,24,WAS,17,0,180,19,59,0.322,3,18,0.167,16,41,0.39,0.347,10,16,0.625,10,12,22,10,5,3,7,8,51
2000-2001,Steve Smith\smithst01,SG,31,POR,81,36,2542,359,788,0.456,78,230,0.339,281,558,0.504,0.505,309,347,0.89,87,185,272,213,48,24,137,203,1105
2000-2001,Tony Smith\smithto02,SG,32,ATL,6,0,78,8,23,0.348,0,2,0,8,21,0.381,0.348,1,2,0.5,2,1,3,10,7,0,9,12,17
2000-2001,Eric Snow\snower01,PG,27,PHI,50,50,1740,182,435,0.418,5,19,0.263,177,416,0.425,0.424,122,154,0.792,27,139,166,369,77,7,124,123,491
2000-2001,Felton Spencer\spencfe01,C,33,NYK,18,0,113,12,20,0.6,0,0,,12,20,0.6,0.6,15,25,0.6,16,19,35,2,2,2,11,24,39
2000-2001,Latrell Sprewell\sprewla01,SF,30,NYK,77,77,3017,524,1219,0.43,41,135,0.304,483,1084,0.446,0.447,275,351,0.783,49,298,347,269,106,28,218,159,1364
2000-2001,Jerry Stackhouse\stackje01,SG,26,DET,80,80,3215,774,1927,0.402,166,473,0.351,608,1454,0.418,0.445,666,810,0.822,99,216,315,410,97,54,326,160,2380
2000-2001,John Starks\starkjo01,SG,35,UTA,75,64,2122,273,686,0.398,64,182,0.352,209,504,0.415,0.445,89,111,0.802,29,125,154,178,73,10,94,217,699
2000-2001,Vladimir Stepania\stepavl01,C,24,NJN,29,0,280,28,88,0.318,1,4,0.25,27,84,0.321,0.324,25,34,0.735,35,74,109,16,10,11,19,47,82
2000-2001,DeShawn Stevenson\stevede01,SG,19,UTA,40,2,293,31,91,0.341,1,12,0.083,30,79,0.38,0.346,26,38,0.684,9,19,28,18,10,2,28,29,89
2000-2001,Michael Stewart\stewami01,C,25,TOR,26,0,123,11,34,0.324,0,0,,11,34,0.324,0.324,11,18,0.611,16,13,29,2,4,3,5,19,33
2000-2001,Bryant Stith\stithbr01,SG,30,BOS,78,74,2504,245,611,0.401,91,242,0.376,154,369,0.417,0.475,175,207,0.845,65,219,284,168,93,14,90,182,756
2000-2001,John Stockton*\stockjo01,PG,38,UTA,82,82,2397,328,651,0.504,61,132,0.462,267,519,0.514,0.551,227,278,0.817,54,173,227,713,132,21,203,194,944
2000-2001,Peja Stojakovic\stojape01,SF,23,SAC,75,75,2905,559,1189,0.47,144,360,0.4,415,829,0.501,0.531,267,312,0.856,93,341,434,164,91,13,146,144,1529
2000-2001,Damon Stoudamire\stoudda01,PG,27,POR,82,82,2655,406,935,0.434,82,219,0.374,324,716,0.453,0.478,172,207,0.831,69,234,303,468,106,8,191,202,1066
2000-2001,Erick Strickland\stricer01,PG,27,TOT,50,0,830,81,267,0.303,30,95,0.316,51,172,0.297,0.36,68,79,0.861,18,110,128,95,44,2,48,88,260
2000-2001,Erick Strickland\stricer01,PG,27,NYK,28,0,421,40,131,0.305,16,47,0.34,24,84,0.286,0.366,24,28,0.857,9,43,52,29,22,1,21,46,120
2000-2001,Erick Strickland\stricer01,PG,27,VAN,22,0,409,41,136,0.301,14,48,0.292,27,88,0.307,0.353,44,51,0.863,9,67,76,66,22,1,27,42,140
2000-2001,Mark Strickland\stricma01,SF,30,TOT,55,2,719,103,239,0.431,1,2,0.5,102,237,0.43,0.433,45,70,0.643,54,107,161,24,16,22,34,72,252
2000-2001,Mark Strickland\stricma01,SF,30,DEN,46,2,517,82,185,0.443,0,1,0,82,184,0.446,0.443,37,59,0.627,43,77,120,17,12,19,24,58,201
2000-2001,Mark Strickland\stricma01,SF,30,NJN,9,0,202,21,54,0.389,1,1,1,20,53,0.377,0.398,8,11,0.727,11,30,41,7,4,3,10,14,51
2000-2001,Rod Strickland\stricro02,PG,34,TOT,54,28,1371,182,429,0.424,4,17,0.235,178,412,0.432,0.429,130,173,0.751,36,104,140,303,53,5,107,76,498
2000-2001,Rod Strickland\stricro02,PG,34,WAS,33,28,1020,141,331,0.426,4,16,0.25,137,315,0.435,0.432,115,147,0.782,25,80,105,231,43,4,83,55,401
2000-2001,Rod Strickland\stricro02,PG,34,POR,21,0,351,41,98,0.418,0,1,0,41,97,0.423,0.418,15,26,0.577,11,24,35,72,10,1,24,21,97
2000-2001,Derek Strong\stronde01,PF,32,LAC,28,8,491,45,117,0.385,0,1,0,45,116,0.388,0.385,28,37,0.757,34,74,108,7,14,1,22,30,118
2000-2001,Bruno Sundov\sundobr01,C,20,IND,11,4,120,20,41,0.488,0,4,0,20,37,0.541,0.488,3,5,0.6,4,19,23,2,2,4,3,21,43
2000-2001,Bob Sura\surabo01,SG,27,GSW,53,42,1684,202,518,0.39,47,172,0.273,155,346,0.448,0.435,135,189,0.714,54,173,227,242,54,8,160,127,586
2000-2001,Stromile Swift\swiftst01,PF,21,VAN,80,6,1312,153,339,0.451,0,4,0,153,335,0.457,0.451,85,141,0.603,109,175,284,28,62,82,64,160,391
2000-2001,Wally Szczerbiak\szczewa02,SF,23,MIN,82,82,2856,469,920,0.51,26,77,0.338,443,843,0.526,0.524,181,208,0.87,133,314,447,260,59,33,138,226,1145
2000-2001,Zan Tabak\tabakza01,C,30,IND,55,14,777,98,186,0.527,0,0,,98,186,0.527,0.527,20,47,0.426,65,148,213,33,10,30,57,125,216
2000-2001,Dragan Tarlac\tarladr01,C,27,CHI,43,12,598,39,99,0.394,0,0,,39,99,0.394,0.394,25,33,0.758,37,85,122,31,7,19,38,95,103
2000-2001,Maurice Taylor\tayloma01,SF,24,HOU,69,69,1972,390,797,0.489,0,4,0,390,793,0.492,0.489,119,162,0.735,109,269,378,104,28,38,125,208,899
2000-2001,Jason Terry\terryja01,SG,23,ATL,82,77,3089,596,1367,0.436,124,314,0.395,472,1053,0.448,0.481,303,358,0.846,42,227,269,403,104,12,239,204,1619
2000-2001,Jamel Thomas\thomaja01,SF,27,NJN,5,0,56,6,19,0.316,1,3,0.333,5,16,0.313,0.342,0,0,,4,5,9,0,3,0,6,6,13
2000-2001,Kenny Thomas\thomake01,PF,23,HOU,74,21,1820,206,465,0.443,25,92,0.272,181,373,0.485,0.47,91,126,0.722,122,295,417,77,40,43,116,178,528
2000-2001,Kurt Thomas\thomaku01,PF,28,NYK,77,29,2125,314,614,0.511,1,3,0.333,313,611,0.512,0.512,171,210,0.814,172,343,515,63,61,69,99,287,800
2000-2001,Tim Thomas\thomati01,PF,23,MIL,76,16,2086,326,758,0.43,107,260,0.412,219,498,0.44,0.501,195,253,0.771,79,234,313,138,78,45,114,194,954
2000-2001,Otis Thorpe\thorpot01,PF,38,CHH,49,4,647,59,131,0.45,0,0,,59,131,0.45,0.45,20,24,0.833,50,95,145,29,12,7,32,108,138
2000-2001,Robert Traylor\traylro01,C,23,CLE,70,7,1212,161,324,0.497,0,2,0,161,322,0.5,0.497,80,141,0.567,124,176,300,63,49,76,98,204,402
2000-2001,Gary Trent\trentga01,PF,26,DAL,33,4,319,57,130,0.438,0,1,0,57,129,0.442,0.438,19,36,0.528,39,53,92,10,13,8,22,52,133
2000-2001,Jake Tsakalidis\tsakaja01,C,21,PHO,57,39,947,101,215,0.47,0,0,,101,215,0.47,0.47,54,91,0.593,83,159,242,19,10,55,66,137,256
2000-2001,Hedo Turkoglu\turkohe01,SF,21,SAC,74,7,1245,138,335,0.412,28,86,0.326,110,249,0.442,0.454,87,112,0.777,49,161,210,69,52,24,55,139,391
2000-2001,Nick Van Exel\vanexni01,PG,29,DEN,71,70,2688,460,1112,0.414,135,358,0.377,325,754,0.431,0.474,204,249,0.819,44,197,241,600,61,18,165,109,1259
2000-2001,Keith Van Horn\vanhoke01,SF,25,NJN,49,47,1733,308,708,0.435,65,170,0.382,243,538,0.452,0.481,150,186,0.806,78,269,347,82,40,20,103,150,831
2000-2001,David Vanterpool\vanteda01,PG,27,WAS,22,0,411,46,110,0.418,0,6,0,46,104,0.442,0.418,30,50,0.6,15,22,37,66,23,3,37,44,122
2000-2001,Jacque Vaughn\vaughja01,PG,25,UTA,82,0,1620,170,393,0.433,30,78,0.385,140,315,0.444,0.471,128,164,0.78,18,132,150,323,48,3,129,145,498
2000-2001,Loy Vaught\vaughlo01,PF,32,TOT,51,1,549,80,169,0.473,0,0,,80,169,0.473,0.473,8,10,0.8,51,122,173,23,21,7,26,74,168
2000-2001,Loy Vaught\vaughlo01,PF,32,DAL,37,1,392,55,121,0.455,0,0,,55,121,0.455,0.455,4,6,0.667,35,88,123,16,15,5,18,61,114
2000-2001,Loy Vaught\vaughlo01,PF,32,WAS,14,0,157,25,48,0.521,0,0,,25,48,0.521,0.521,4,4,1,16,34,50,7,6,2,8,13,54
2000-2001,Jake Voskuhl\voskuja01,C,23,CHI,16,2,143,11,25,0.44,0,0,,11,25,0.44,0.44,8,14,0.571,12,22,34,5,5,6,12,38,30
2000-2001,Antoine Walker\walkean02,PF,24,BOS,81,81,3396,711,1720,0.413,221,603,0.367,490,1117,0.439,0.478,249,348,0.716,151,568,719,445,138,49,301,251,1892
2000-2001,Samaki Walker\walkesa01,PF,24,SAS,61,1,963,121,252,0.48,1,3,0.333,120,249,0.482,0.482,78,124,0.629,67,176,243,29,10,41,68,103,321
2000-2001,Ben Wallace\wallabe01,C,26,DET,80,80,2760,215,439,0.49,1,4,0.25,214,435,0.492,0.491,80,238,0.336,303,749,1052,123,107,186,117,192,511
2000-2001,John Wallace\wallajo01,SF,26,DET,40,0,527,100,236,0.424,2,15,0.133,98,221,0.443,0.428,35,45,0.778,25,58,83,23,13,16,36,72,237
2000-2001,Rasheed Wallace\wallara01,PF,26,POR,77,75,2940,590,1178,0.501,52,162,0.321,538,1016,0.53,0.523,245,320,0.766,147,455,602,212,90,135,158,206,1477
2000-2001,Charlie Ward\wardch01,PG,30,NYK,61,33,1492,155,373,0.416,67,175,0.383,88,198,0.444,0.505,56,70,0.8,32,127,159,273,70,10,112,132,433
2000-2001,Clarence Weatherspoon\weathcl01,PF,30,CLE,82,82,2774,347,692,0.501,0,0,,347,692,0.501,0.501,230,291,0.79,223,573,796,103,85,105,112,171,924
2000-2001,Chris Webber\webbech01,PF,27,SAC,70,70,2836,786,1635,0.481,2,28,0.071,784,1607,0.488,0.481,324,461,0.703,179,598,777,294,93,118,195,226,1898
2000-2001,Bonzi Wells\wellsbo01,SF,24,POR,75,46,1995,387,726,0.533,17,50,0.34,370,676,0.547,0.545,159,240,0.663,120,247,367,208,94,20,169,203,950
2000-2001,David Wesley\wesleda01,SG,30,CHH,82,82,3106,523,1239,0.422,97,258,0.376,426,981,0.434,0.461,271,339,0.799,64,160,224,361,128,16,171,220,1414
2000-2001,Doug West\westdo01,SG,33,VAN,15,6,171,11,38,0.289,0,2,0,11,36,0.306,0.289,6,7,0.857,4,11,15,14,3,4,4,21,28
2000-2001,Jahidi White\whiteja01,C,24,WAS,68,56,1609,203,408,0.498,0,1,0,203,407,0.499,0.498,177,312,0.567,178,343,521,20,32,111,136,211,583
2000-2001,Chris Whitney\whitnch01,PG,29,WAS,59,31,1532,182,470,0.387,93,248,0.375,89,222,0.401,0.486,101,113,0.894,12,94,106,248,55,3,103,150,558
2000-2001,Aaron Williams\williaa01,PF,29,NJN,82,25,2336,297,650,0.457,0,2,0,297,648,0.458,0.457,244,310,0.787,211,379,590,88,59,113,132,319,838
2000-2001,Alvin Williams\willial02,SG,26,TOR,82,34,2394,330,767,0.43,33,108,0.306,297,659,0.451,0.452,109,145,0.752,50,162,212,407,123,26,103,171,802
2000-2001,Eric Williams\willier01,SF,28,BOS,81,11,1745,162,448,0.362,46,139,0.331,116,309,0.375,0.413,165,231,0.714,64,143,207,112,64,13,76,179,535
2000-2001,Jason Williams\willija02,PG,25,SAC,77,77,2290,281,690,0.407,98,311,0.315,183,379,0.483,0.478,60,76,0.789,19,166,185,416,94,9,160,114,720
2000-2001,Jerome Williams\willije01,PF,27,TOT,59,2,1182,136,294,0.463,0,3,0,136,291,0.467,0.463,100,135,0.741,133,249,382,45,57,20,63,124,372
2000-2001,Jerome Williams\willije01,PF,27,DET,33,2,804,88,201,0.438,0,2,0,88,199,0.442,0.438,65,90,0.722,98,180,278,32,39,10,47,81,241
2000-2001,Jerome Williams\willije01,PF,27,TOR,26,0,378,48,93,0.516,0,1,0,48,92,0.522,0.516,35,45,0.778,35,69,104,13,18,10,16,43,131
2000-2001,Monty Williams\willimo01,SF,29,ORL,82,0,1211,162,364,0.445,1,13,0.077,161,351,0.459,0.446,85,133,0.639,86,157,243,79,29,16,85,136,410
2000-2001,Scott Williams\willisc01,C,32,MIL,66,31,1272,171,361,0.474,1,4,0.25,170,357,0.476,0.475,60,70,0.857,97,267,364,35,48,32,41,178,403
2000-2001,Shammond Williams\willish01,PG,25,SEA,69,6,1238,161,368,0.438,61,133,0.459,100,235,0.426,0.52,84,96,0.875,34,98,132,190,31,4,82,83,467
2000-2001,Walt Williams\williwa02,SF,30,HOU,72,31,1583,202,513,0.394,98,248,0.395,104,265,0.392,0.489,97,126,0.77,31,214,245,97,30,28,73,153,599
2000-2001,Corliss Williamson\willico02,SF,27,TOT,69,40,1686,325,647,0.502,0,2,0,325,645,0.504,0.502,151,237,0.637,110,211,321,61,50,21,110,185,801
2000-2001,Corliss Williamson\willico02,SF,27,TOR,42,31,886,153,325,0.471,0,2,0,153,323,0.474,0.471,84,130,0.646,57,96,153,33,15,13,65,98,390
2000-2001,Corliss Williamson\willico02,SF,27,DET,27,9,800,172,322,0.534,0,0,,172,322,0.534,0.534,67,107,0.626,53,115,168,28,35,8,45,87,411
2000-2001,Kevin Willis\willike02,C,38,TOT,78,22,1830,304,690,0.441,1,6,0.167,303,684,0.443,0.441,113,147,0.769,177,355,532,50,57,52,87,216,722
2000-2001,Kevin Willis\willike02,C,38,TOR,35,9,771,124,269,0.461,0,2,0,124,267,0.464,0.461,61,81,0.753,68,155,223,21,19,21,40,78,309
2000-2001,Kevin Willis\willike02,C,38,DEN,43,13,1059,180,421,0.428,1,4,0.25,179,417,0.429,0.429,52,66,0.788,109,200,309,29,38,31,47,138,413
2000-2001,David Wingate\wingada01,SG,37,SEA,1,0,9,3,3,1,0,0,,3,3,1,1,0,0,,0,0,0,2,0,0,0,1,6
2000-2001,Ruben Wolkowyski\wolkoru01,PF,27,SEA,34,1,305,25,79,0.316,0,2,0,25,77,0.325,0.316,25,34,0.735,12,34,46,3,6,18,12,38,75
2000-2001,Metta World Peace\artesro01,SF,21,CHI,76,74,2363,327,815,0.401,43,148,0.291,284,667,0.426,0.428,210,280,0.75,59,235,294,228,152,45,159,254,907
2000-2001,Lorenzen Wright\wrighlo02,C,25,ATL,71,46,1988,363,811,0.448,0,2,0,363,809,0.449,0.448,155,216,0.718,180,355,535,87,42,63,125,232,881
2000-2001,Wang Zhizhi\zhizhwa01,C,23,DAL,5,0,38,8,19,0.421,0,2,0,8,17,0.471,0.421,8,10,0.8,1,6,7,0,0,0,1,8,24